version 1, schema effects_tables, guid 505c8db2-2bd2-4b7b-85ad-b10e308db947
Effect_ID(string)	Pip_Path(optstring)	Unknown1(int)
"Command_Land_Attack"	"data/ui/campaign ui/pips/effect_admiral.tga"	310
"Command_Land_Cavalry_Troops"	"data/ui/campaign ui/pips/effect_admiral.tga"	309
"Command_Land_Defence"	"data/ui/campaign ui/pips/effect_admiral.tga"	307
"Command_Land_Siege_Attack"	"data/ui/campaign ui/pips/effect_admiral.tga"	303
"Command_Land_Siege_Defence"	"data/ui/campaign ui/pips/effect_admiral.tga"	302
"Command_mod"	"data/ui/campaign ui/pips/effect_admiral.tga"	999
"Movement_Points_All"	"data/ui/campaign ui/effect_bundles/effect_army.tga"	1
"Movement_Points_All_Land"	"data/ui/campaign ui/effect_bundles/effect_army.tga"	1
"Movement_Points_Land_Artillery"	"data/ui/campaign ui/effect_bundles/effect_army.tga"	1
"Movement_Points_Land_Cavalry"	"data/ui/campaign ui/effect_bundles/effect_cavalry.tga"	1
"Movement_Points_Land_Infantry"	"data/ui/campaign ui/effect_bundles/effect_army.tga"	1
"Xcommodity_price_mod"	"data/ui/campaign ui/effect_bundles/effect_wealth.tga"	0
"Xgdp_building"	"data/ui/campaign ui/effect_bundles/effect_wealth.tga"	5
"Xpop_growth_buildings"	"data/ui/campaign ui/effect_bundles/effect_wealth.tga"	5
"Xtax_cap"	"data/ui/campaign ui/effect_bundles/effect_wealth.tga"	1
"Xtw_growth"	"data/ui/campaign ui/effect_bundles/effect_wealth.tga"	1
"admin_cost_mod"	"data/ui/campaign ui/effect_bundles/effect_wealth_positive.tga"	8005
"agent_XP_mod_ikko_monk"	"data/ui/campaign ui/effect_bundles/effect_ikko_monk.tga"	3456
"agent_XP_mod_mesuke"	"data/ui/campaign ui/effect_bundles/effect_metsuke.tga"	502
"agent_XP_mod_missionary"	"data/ui/campaign ui/effect_bundles/effect_missionary.tga"	506
"agent_XP_mod_monk"	"data/ui/campaign ui/effect_bundles/effect_monk.tga"	504
"agent_XP_mod_ninja"	"data/ui/campaign ui/effect_bundles/effect_ninja.tga"	503
"agent_action_cost_mod"	"data/ui/campaign ui/effect_bundles/effect_character_positive.tga"	999
"agent_action_critical_success_mod"	"data/ui/campaign ui/effect_bundles/effect_character_positive.tga"	998
"agent_action_success_mod"	"data/ui/campaign ui/effect_bundles/effect_character_positive.tga"	997
"agent_attribute_cunning_apprehension"	"data/ui/campaign ui/effect_bundles/effect_metsuke_positive.tga"	9998
"agent_attribute_cunning_bribery"	"data/ui/campaign ui/effect_bundles/effect_metsuke_positive.tga"	9997
"agent_attribute_cunning_counterspying"	"data/ui/campaign ui/effect_bundles/effect_metsuke_positive.tga"	9996
"agent_attribute_cunning_oversee_army"	"data/ui/campaign ui/effect_bundles/effect_metsuke_positive.tga"	9995
"agent_attribute_cunning_oversee_town"	"data/ui/campaign ui/effect_bundles/effect_metsuke_positive.tga"	9994
"agent_attribute_mod_metsuke"	"data/ui/campaign ui/pips/effect_admiral.tga"	3
"agent_attribute_subterfuge_assassination"	"data/ui/campaign ui/effect_bundles/effect_subterfuge_positive.tga"	9993
"agent_attribute_subterfuge_field_scout"	"data/ui/campaign ui/effect_bundles/effect_subterfuge_positive.tga"	9992
"agent_attribute_subterfuge_sabotage_army"	"data/ui/campaign ui/effect_bundles/effect_subterfuge_positive.tga"	9991
"agent_attribute_subterfuge_sabotage_building"	"data/ui/campaign ui/effect_bundles/effect_subterfuge_positive.tga"	9990
"agent_attribute_subterfuge_spy_network"	"data/ui/campaign ui/effect_bundles/effect_subterfuge_positive.tga"	9989
"agent_attribute_subterfuge_spying"	"data/ui/campaign ui/effect_bundles/effect_subterfuge_positive.tga"	9988
"agent_attribute_zeal_conversion"	"data/ui/campaign ui/effect_bundles/effect_religion_positive.tga"	9987
"agent_attribute_zeal_convert_character"	"data/ui/campaign ui/effect_bundles/effect_religion_positive.tga"	9986
"agent_attribute_zeal_demoralise_army"	"data/ui/campaign ui/effect_bundles/effect_religion_positive.tga"	9985
"agent_attribute_zeal_incite_unrest"	"data/ui/campaign ui/effect_bundles/effect_religion_positive.tga"	9984
"agent_attribute_zeal_inspire_army"	"data/ui/campaign ui/effect_bundles/effect_religion_positive.tga"	9983
"agent_attribute_zeal_inspire_town"	"data/ui/campaign ui/effect_bundles/effect_religion_positive.tga"	9982
"agent_availability_quality_geisha"	"data/ui/campaign ui/effect_bundles/effect_geisha.tga"	21
"agent_availability_quality_ikko_monk"	"data/ui/campaign ui/effect_bundles/effect_ikko_monk.tga"	1
"agent_availability_quality_metsuke"	"data/ui/campaign ui/effect_bundles/effect_metsuke.tga"	19
"agent_availability_quality_missionary"	"data/ui/campaign ui/effect_bundles/effect_missionary.tga"	20
"agent_availability_quality_monk"	"data/ui/campaign ui/effect_bundles/effect_monk.tga"	18
"agent_availability_quality_ninja"	"data/ui/campaign ui/effect_bundles/effect_ninja.tga"	22
"agent_cap_basic_hidden"	"data/ui/campaign ui/pips/effect_admiral.tga"	0
"agent_cap_geisha"	"data/ui/campaign ui/effect_bundles/effect_geisha.tga"	3567
"agent_cap_general"	"data/ui/campaign ui/effect_bundles/effect_general.tga"	120
"agent_cap_ikko_monk"	"data/ui/campaign ui/effect_bundles/effect_ikko_monk.tga"	1234
"agent_cap_metsuke"	"data/ui/campaign ui/effect_bundles/effect_metsuke.tga"	3455
"agent_cap_minja"	"data/ui/campaign ui/effect_bundles/effect_ninja.tga"	2345
"agent_cap_missionary"	"data/ui/campaign ui/effect_bundles/effect_missionary.tga"	111
"agent_cap_monk"	"data/ui/campaign ui/effect_bundles/effect_monk.tga"	3456
"agent_general_refil_rate_1"	"data/ui/campaign ui/effect_bundles/effect_general.tga"	119
"agent_general_refil_rate_2"	"data/ui/campaign ui/effect_bundles/effect_genral.tga"	119
"agent_metsuke_release_time_mod"	"data/ui/campaign ui/effect_bundles/effect_metsuke.tga"	555
"agent_ninja_killing_chance_mod"	"data/ui/campaign ui/effect_bundles/effect_ninja_positive.tga"	556
"agent_ninja_ninjutsu"	"data/ui/campaign ui/effect_bundles/effect_ninja.tga"	557
"agent_ninja_stealth_mod"	"data/ui/campaign ui/effect_bundles/effect_ninja.tga"	558
"agent_ninja_wounding_time_mod"	"data/ui/campaign ui/effect_bundles/effect_ninja.tga"	559
"agent_stealth_detection_mod"	"data/ui/campaign ui/effect_bundles/effect_character.tga"	25
"ai_region_resistance_modifier"	"data/ui/campaign ui/pips/effect_admiral.tga"	0
"ancillary_test"	"data/ui/campaign ui/effect_bundles/effect_character.tga"	0
"attrition_mod"	"data/ui/campaign ui/effect_bundles/effect_army.tga"	5
"bos_agent_XP_mod_geisha"	"data/ui/campaign ui/effect_bundles/bos_effect_geisha_positive.tga"	331
"bos_agent_action_cost_mod"	"data/ui/campaign ui/effect_bundles/bos_effect_wealth_positive.tga"	50
"bos_agent_action_success_mod"	"data/ui/campaign ui/effect_bundles/bos_effect_character_positive.tga"	50
"bos_agent_attribute_geisha_distract_army"	"data/ui/campaign ui/effect_bundles/bos_effect_army.tga"	100
"bos_agent_attribute_geisha_distract_garrison"	"data/ui/campaign ui/effect_bundles/bos_effect_seige_defence.tga"	100
"bos_agent_attribute_geisha_enchant_enemy"	"data/ui/campaign ui/effect_bundles/bos_effect_geisha.tga"	100
"bos_agent_attribute_geisha_entertain_nobles"	"data/ui/campaign ui/effect_bundles/bos_effect_daimyo_positive.tga"	100
"bos_agent_attribute_geisha_inspire_troops"	"data/ui/campaign ui/effect_bundles/bos_effect_army_positive.tga"	100
"bos_agent_attribute_geisha_performance"	"data/ui/campaign ui/effect_bundles/bos_effect_geisha_positive.tga"	100
"bos_agent_attribute_ishin_shinsen_assassination"	"data/ui/campaign ui/effect_bundles/bos_effect_melee.tga"	100
"bos_agent_attribute_ishin_shinsen_conversion"	"data/ui/campaign ui/effect_bundles/bos_effect_daimyo.tga"	100
"bos_agent_attribute_ishin_shinsen_counterspying"	"data/ui/campaign ui/effect_bundles/bos_effect_ishin_shishi_positive.tga"	100
"bos_agent_attribute_ishin_shinsen_incite_revolt"	"data/ui/campaign ui/effect_bundles/bos_effect_disaster.tga"	100
"bos_agent_attribute_ishinshishi_instil_fervour"	"data/ui/campaign ui/effect_bundles/bos_effect_army_positive.tga"	100
"bos_agent_attribute_ishinshishi_persuade_troops"	"data/ui/campaign ui/effect_bundles/bos_effect_army.tga"	100
"bos_agent_attribute_ishinshishi_rally_populace"	"data/ui/campaign ui/effect_bundles/bos_effect_ishin_shishi_positive.tga"	100
"bos_agent_attribute_shinobi_army_sabotage"	"data/ui/campaign ui/effect_bundles/bos_effect_army.tga"	100
"bos_agent_attribute_shinobi_assassination"	"data/ui/campaign ui/effect_bundles/bos_effect_melee.tga"	100
"bos_agent_attribute_shinobi_building_sabotage"	"data/ui/campaign ui/effect_bundles/bos_effect_disaster_negative.tga"	100
"bos_agent_attribute_shinobi_scouting"	"data/ui/campaign ui/effect_bundles/bos_effect_army_positive.tga"	100
"bos_agent_attribute_shinobi_spy_network"	"data/ui/campaign ui/effect_bundles/bos_effect_subterfuge_positive.tga"	100
"bos_agent_attribute_shinobi_spying"	"data/ui/campaign ui/effect_bundles/bos_effect_subterfuge_positive.tga"	100
"bos_agent_attribute_shinsengumi_coerce_troops"	"data/ui/campaign ui/effect_bundles/bos_effect_army.tga"	100
"bos_agent_attribute_shinsengumi_instil_discipline"	"data/ui/campaign ui/effect_bundles/bos_effect_army_positive.tga"	100
"bos_agent_attribute_shinsengumi_subdue_dissidents"	"data/ui/campaign ui/effect_bundles/bos_effect_shinsengumi_positive.tga"	100
"bos_agent_attribute_veteran_administration"	"data/ui/campaign ui/effect_bundles/bos_effect_general_positive.tga"	100
"bos_agent_attribute_veteran_building_sabotage"	"data/ui/campaign ui/effect_bundles/bos_effect_disaster_negative.tga"	100
"bos_agent_attribute_veteran_harass"	"data/ui/campaign ui/effect_bundles/bos_effect_army.tga"	100
"bos_agent_attribute_veteran_single_combat"	"data/ui/campaign ui/effect_bundles/bos_effect_traditional_infantry_melee.tga"	100
"bos_agent_attribute_veteran_supervise_recruitment"	"data/ui/campaign ui/effect_bundles/bos_effect_general_positive.tga"	100
"bos_agent_attribute_veteran_train_troops"	"data/ui/campaign ui/effect_bundles/bos_effect_military_positive.tga"	100
"bos_agent_availability_quality_geisha"	"data/ui/campaign ui/effect_bundles/bos_effect_geisha.tga"	333
"bos_agent_availability_quality_ishinshishi"	"data/ui/campaign ui/effect_bundles/bos_effect_ishin_shishi.tga"	341
"bos_agent_availability_quality_shinobi"	"data/ui/campaign ui/effect_bundles/bos_effect_ninja.tga"	371
"bos_agent_availability_quality_shinsengumi"	"data/ui/campaign ui/effect_bundles/bos_effect_shinsengumi.tga"	340
"bos_agent_availability_quality_veteran"	"data/ui/campaign ui/effect_bundles/bos_effect_foreign_veteran.tga"	354
"bos_agent_cap_geisha"	"data/ui/campaign ui/effect_bundles/bos_effect_geisha.tga"	0
"bos_agent_cap_ishinshishi"	"data/ui/campaign ui/effect_bundles/bos_effect_ishin_shishi.tga"	10
"bos_agent_cap_shinobi"	"data/ui/campaign ui/effect_bundles/bos_effect_ninja.tga"	0
"bos_agent_cap_shinsengumi"	"data/ui/campaign ui/effect_bundles/bos_effect_shinsengumi.tga"	0
"bos_agent_cap_veteran"	"data/ui/campaign ui/effect_bundles/bos_effect_foreign_veteran.tga"	0
"bos_agent_critical_success_mod"	"data/ui/campaign ui/effect_bundles/bos_effect_character_positive.tga"	50
"bos_agent_geisha_happiness_bonus"	"data/ui/campaign ui/effect_bundles/bos_effect_public_order_positive.tga"	50
"bos_agent_maximum_cap_all"	"data/ui/campaign ui/effect_bundles/bos_effect_character.tga"	50
"bos_agent_maximum_cap_geisha"	"data/ui/campaign ui/effect_bundles/bos_effect_geisha.tga"	50
"bos_agent_maximum_cap_ishinshishi"	"data/ui/campaign ui/effect_bundles/bos_effect_ishin_shishi.tga"	50
"bos_agent_maximum_cap_shinobi"	"data/ui/campaign ui/effect_bundles/bos_effect_ninja.tga"	50
"bos_agent_maximum_cap_shinsengumi"	"data/ui/campaign ui/effect_bundles/bos_effect_shinsengumi.tga"	50
"bos_agent_maximum_cap_veteran"	"data/ui/campaign ui/effect_bundles/bos_effect_foreign_veteran.tga"	0
"bos_agent_mod_action_fail_cost"	"data/ui/campaign ui/effect_bundles/bos_effect_subterfuge_negative.tga"	100
"bos_agent_mod_all_upkeep"	"data/ui/campaign ui/effect_bundles/bos_effect_wealth_positive.tga"	100
"bos_agent_mod_army_charge_bonus"	"data/ui/campaign ui/effect_bundles/bos_effect_charge_positive.tga"	100
"bos_agent_mod_army_melee"	"data/ui/campaign ui/effect_bundles/bos_effect_melee_positive.tga"	100
"bos_agent_mod_detection_range"	"data/ui/campaign ui/effect_bundles/bos_effect_subterfuge.tga"	100
"bos_agent_mod_enchantability"	"data/ui/campaign ui/effect_bundles/bos_effect_geisha.tga"	100
"bos_agent_mod_happiness_global"	"data/ui/campaign ui/effect_bundles/bos_effect_public_order_positive.tga"	100
"bos_agent_mod_kill_aggressor_chance"	"data/ui/campaign ui/effect_bundles/bos_effect_melee.tga"	100
"bos_agent_mod_naval_support_cooldown"	"data/ui/campaign ui/effect_bundles/bos_effect_coastal_defences_positive.tga"	100
"bos_agent_mod_repression_global"	"data/ui/campaign ui/effect_bundles/bos_effect_public_order.tga"	100
"bos_agent_mod_sabotage_building_damage"	"data/ui/campaign ui/effect_bundles/bos_effect_disaster_negative.tga"	100
"bos_agent_repression_local"	"data/ui/campaign ui/effect_bundles/bos_effect_public_order.tga"	100
"bos_agent_shinobi_stealth_mod"	"data/ui/campaign ui/effect_bundles/bos_effect_subterfuge_positive.tga"	100
"bos_agent_single_combat_survival_chance"	"data/ui/campaign ui/effect_bundles/bos_effect_traditional_infantry_melee_positive.tga"	100
"bos_agent_veteran_mod_ammunition"	"data/ui/campaign ui/effect_bundles/bos_effect_modern_infantry_ranged_positive.tga"	100
"bos_ancillary_accuracy_mod_all"	"data/ui/campaign ui/effect_bundles/bos_effect_accuracy_positive.tga"	2
"bos_ancillary_accuracy_mod_artillery"	"data/ui/campaign ui/effect_bundles/bos_effect_accuracy_positive.tga"	79
"bos_ancillary_accuracy_mod_bows"	"data/ui/campaign ui/effect_bundles/bos_effect_accuracy_positive.tga"	2
"bos_ancillary_attrition_mod"	"data/ui/campaign ui/effect_bundles/bos_effect_army_positive.tga"	2
"bos_ancillary_charge_bonus_mod_cavalry"	"data/ui/campaign ui/effect_bundles/bos_effect_charge_positive.tga"	2
"bos_ancillary_construction_cost_mod_all"	"data/ui/campaign ui/effect_bundles/bos_effect_construction_positive.tga"	2
"bos_ancillary_construction_cost_mod_indsustry"	"data/ui/campaign ui/effect_bundles/bos_effect_construction_positive.tga"	2
"bos_ancillary_construction_cost_mod_rails"	"data/ui/campaign ui/effect_bundles/bos_effect_construction_positive.tga"	2
"bos_ancillary_construction_time_mod_rails"	"data/ui/campaign ui/effect_bundles/bos_effect_construction_positive.tga"	2
"bos_ancillary_melee_attack_mod_bodyguard"	"data/ui/campaign ui/effect_bundles/bos_effect_melee_positive.tga"	2
"bos_ancillary_melee_attack_mod_sword"	"data/ui/campaign ui/effect_bundles/bos_effect_melee_positive.tga"	2
"bos_ancillary_melee_attack_mod_traditional"	"data/ui/campaign ui/effect_bundles/bos_effect_melee_positive.tga"	2
"bos_ancillary_melee_defence_mod_all"	"data/ui/campaign ui/effect_bundles/bos_effect_army_positive.tga"	2
"bos_ancillary_movement_point_mod_ships"	"data/ui/campaign ui/effect_bundles/bos_effect_admiral_positive.tga"	2
"bos_ancillary_reinforcement_range_mod"	"data/ui/campaign ui/effect_bundles/bos_effect_army_positive.tga"	2
"bos_ancillary_reload_mod_rifles"	"data/ui/campaign ui/effect_bundles/bos_effect_modern_infantry_ranged_positive.tga"	2
"bos_ancillary_replenishment_mod"	"data/ui/campaign ui/effect_bundles/bos_effect_army_positive.tga"	2
"bos_ancillary_research_mod_both"	"data/ui/campaign ui/effect_bundles/bos_effect_technology_positive.tga"	2
"bos_building_construction_time_mod_all"	"data/ui/campaign ui/effect_bundles/bos_effect_construction.tga"	328
"bos_building_cost_mod_local"	"data/ui/campaign ui/effect_bundles/bos_effect_wealth.tga"	374
"bos_building_legendary"	"data/ui/campaign ui/effect_bundles/bos_effect_daimyo_positive.tga"	1
"bos_castle_slot_addition"	"data/ui/campaign ui/effect_bundles/bos_effect_construction_positive.tga"	391
"bos_clan_trait_aizu_castle_cost_mod"	"data/ui/campaign ui/effect_bundles/bos_effect_construction.tga"	50
"bos_clan_trait_aizu_shinsengumi_action_cost_mod"	"data/ui/campaign ui/effect_bundles/bos_effect_shinsengumi.tga"	50
"bos_clan_trait_aizu_trad_unit_cost_mod"	"data/ui/campaign ui/effect_bundles/bos_effect_army.tga"	50
"bos_clan_trait_aizu_trad_unit_xp_mod"	"data/ui/campaign ui/effect_bundles/bos_effect_army.tga"	50
"bos_clan_trait_choshu_ishin_shishi_action_mod"	"data/ui/campaign ui/effect_bundles/bos_effect_ishin_shishi.tga"	50
"bos_clan_trait_choshu_loot_mod"	"data/ui/campaign ui/effect_bundles/bos_effect_army.tga"	50
"bos_clan_trait_choshu_military_cost_mod"	"data/ui/campaign ui/effect_bundles/bos_effect_army.tga"	50
"bos_clan_trait_chosu_charge"	"data/ui/campaign ui/effect_bundles/bos_effect_charge_positive.tga"	50
"bos_clan_trait_jozai_battle_movement_mod"	"data/ui/campaign ui/effect_bundles/bos_effect_army.tga"	50
"bos_clan_trait_jozai_guerrilla_unit_cap_mod"	"data/ui/campaign ui/effect_bundles/bos_effect_army.tga"	50
"bos_clan_trait_jozai_harassment"	"data/ui/campaign ui/effect_bundles/bos_effect_disaster_negative.tga"	50
"bos_clan_trait_jozai_replenishment"	"data/ui/campaign ui/effect_bundles/bos_effect_army.tga"	50
"bos_clan_trait_nagaoka_criminal_income_mod"	"data/ui/campaign ui/effect_bundles/bos_effect_wealth.tga"	50
"bos_clan_trait_nagaoka_geisha_success"	"data/ui/campaign ui/effect_bundles/bos_effect_geisha.tga"	50
"bos_clan_trait_nagaoka_modern_unit_cost_mod"	"data/ui/campaign ui/effect_bundles/bos_effect_army.tga"	50
"bos_clan_trait_nagaoka_rifle_reload_speed"	"data/ui/campaign ui/effect_bundles/bos_effect_public_order.tga"	50
"bos_clan_trait_obama_garrison_xp_mod"	"data/ui/campaign ui/effect_bundles/bos_effect_army.tga"	50
"bos_clan_trait_obama_land_upkeep"	"data/ui/campaign ui/effect_bundles/bos_effect_army.tga"	50
"bos_clan_trait_obama_repression"	"data/ui/campaign ui/effect_bundles/bos_effect_public_order.tga"	50
"bos_clan_trait_obama_tax_mod"	"data/ui/campaign ui/effect_bundles/bos_effect_wealth.tga"	50
"bos_clan_trait_saga_artillery"	"data/ui/campaign ui/effect_bundles/bos_effect_army.tga"	50
"bos_clan_trait_saga_growth_industry_mod"	"data/ui/campaign ui/effect_bundles/bos_effect_wealth.tga"	50
"bos_clan_trait_saga_ship_cost_mod"	"data/ui/campaign ui/effect_bundles/bos_effect_navy.tga"	50
"bos_clan_trait_saga_western_trade"	"data/ui/campaign ui/effect_bundles/bos_effect_trade.tga"	50
"bos_clan_trait_satsuma_admin"	"data/ui/campaign ui/effect_bundles/bos_effect_wealth.tga"	50
"bos_clan_trait_satsuma_agent_action_cost"	"data/ui/campaign ui/effect_bundles/bos_effect_foreign_veteran.tga"	50
"bos_clan_trait_satsuma_general_aoe"	"data/ui/campaign ui/effect_bundles/bos_effect_general_positive.tga"	50
"bos_clan_trait_satsuma_regions"	"data/ui/campaign ui/effect_bundles/bos_effect_faction_satsuma_positive.tga"	50
"bos_clan_trait_sendai_allegiance_tolerance_mod"	"data/ui/campaign ui/effect_bundles/bos_effect_allegiance_positive.tga"	50
"bos_clan_trait_sendai_battle_time_mod"	"data/ui/campaign ui/effect_bundles/bos_effect_army.tga"	50
"bos_clan_trait_sendai_diplomacy_mod"	"data/ui/campaign ui/effect_bundles/bos_effect_diplomacy.tga"	50
"bos_clan_trait_sendai_resistance_to_occupation_mod"	"data/ui/campaign ui/effect_bundles/bos_effect_public_order.tga"	50
"bos_clan_trait_tosa_diplomacy"	"data/ui/campaign ui/effect_bundles/bos_effect_diplomacy.tga"	50
"bos_clan_trait_tosa_naval_bombardments"	"data/ui/campaign ui/effect_bundles/bos_effect_navy.tga"	50
"bos_clan_trait_tosa_resistance_to_occupation_mod"	"data/ui/campaign ui/effect_bundles/bos_effect_public_order.tga"	50
"bos_clan_trait_tosa_ship_xp_mod"	"data/ui/campaign ui/effect_bundles/bos_effect_navy.tga"	50
"bos_clan_trait_tsu_conversion_mod"	"data/ui/campaign ui/effect_bundles/bos_effect_allegiance_positive.tga"	50
"bos_clan_trait_tsu_defence_mod"	"data/ui/campaign ui/effect_bundles/bos_effect_army.tga"	50
"bos_clan_trait_tsu_kiso_cap_mod"	"data/ui/campaign ui/effect_bundles/bos_effect_ninja.tga"	50
"bos_clan_trait_tsu_shinobi_action_cost_mod"	"data/ui/campaign ui/effect_bundles/bos_effect_ninja.tga"	50
"bos_coastal_defence_damage_to_disable"	"data/ui/campaign ui/effect_bundles/bos_effect_coastal_defences.tga"	500
"bos_coastal_defence_quality_and_availability"	"data/ui/campaign ui/effect_bundles/bos_effect_coastal_defences.tga"	360
"bos_coastal_defence_zone_range"	"data/ui/campaign ui/effect_bundles/bos_effect_coastal_defences.tga"	400
"bos_conversion_imperial"	"data/ui/campaign ui/effect_bundles/bos_effect_imperial_allegiance.tga"	342
"bos_conversion_imperial_osmosis"	"data/ui/campaign ui/effect_bundles/bos_effect_imperial_allegiance.tga"	343
"bos_conversion_independent"	"data/ui/campaign ui/effect_bundles/bos_effect_independant_allegiance.tga"	346
"bos_conversion_independent_osmosis"	"data/ui/campaign ui/effect_bundles/bos_effect_independant_allegiance.tga"	347
"bos_conversion_shogunate"	"data/ui/campaign ui/effect_bundles/bos_effect_shogunate_allegiance.tga"	344
"bos_conversion_shogunate_osmosis"	"data/ui/campaign ui/effect_bundles/bos_effect_shogunate_allegiance.tga"	345
"bos_defenses_gatling_gun_towers"	"data/ui/campaign ui/effect_bundles/bos_effect_seige_defence.tga"	357
"bos_defenses_matchlock_tower"	"data/ui/campaign ui/effect_bundles/bos_effect_seige_defence.tga"	356
"bos_defenses_wall_and_gatling_gun_towers"	"data/ui/campaign ui/effect_bundles/bos_effect_seige_defence.tga"	359
"bos_enable_military_mission"	"data/ui/campaign ui/effect_bundles/bos_effect_diplomacy.tga"	1
"bos_enable_night_battles"	"data/ui/campaign ui/effect_bundles/bos_effect_night_battle.tga"	50
"bos_enable_night_battles_naval"	"data/ui/campaign ui/effect_bundles/bos_effect_night_battle.tga"	50
"bos_enable_stand_and_fight"	"data/ui/campaign ui/effect_bundles/bos_effect_army_positive.tga"	50
"bos_enemy_morale_mod"	"data/ui/campaign ui/effect_bundles/bos_effect_morale_negative.tga"	50
"bos_escape_chance_action_mod"	"data/ui/campaign ui/effect_bundles/bos_effect_character_positive.tga"	50
"bos_escape_chance_mod"	"data/ui/campaign ui/effect_bundles/bos_effect_character_positive.tga"	50
"bos_event_building_cost_mod_civil"	"data/ui/campaign ui/effect_bundles/bos_effect_construction_positive.tga"	50
"bos_event_building_cost_mod_military"	"data/ui/campaign ui/effect_bundles/bos_effect_construction_positive.tga"	50
"bos_event_building_cost_mod_propaganda_local"	"data/ui/campaign ui/effect_bundles/bos_effect_construction_positive.tga"	50
"bos_event_building_time_mod_civil"	"data/ui/campaign ui/effect_bundles/bos_effect_construction_positive.tga"	50
"bos_event_building_time_mod_military"	"data/ui/campaign ui/effect_bundles/bos_effect_construction_positive.tga"	50
"bos_event_building_time_mod_propaganda_local"	"data/ui/campaign ui/effect_bundles/bos_effect_construction_positive.tga"	50
"bos_event_diplomacy"	"data/ui/campaign ui/effect_bundles/bos_effect_diplomacy.tga"	50
"bos_event_gdp_mod_all_global"	"data/ui/campaign ui/effect_bundles/bos_effect_wealth.tga"	50
"bos_event_gdp_mod_all_local"	"data/ui/campaign ui/effect_bundles/bos_effect_wealth.tga"	50
"bos_event_gdp_mod_commerce_local"	"data/ui/campaign ui/effect_bundles/bos_effect_wealth.tga"	50
"bos_event_gdp_mod_farms_mines"	"data/ui/campaign ui/effect_bundles/bos_effect_wealth.tga"	50
"bos_event_gdp_mod_industry"	"data/ui/campaign ui/effect_bundles/bos_effect_wealth.tga"	50
"bos_event_gdp_mod_population_global"	"data/ui/campaign ui/effect_bundles/bos_effect_wealth.tga"	50
"bos_event_gdp_mod_population_local"	"data/ui/campaign ui/effect_bundles/bos_effect_wealth.tga"	50
"bos_event_gdp_mod_province_capital"	"data/ui/campaign ui/effect_bundles/bos_effect_wealth.tga"	50
"bos_event_growth_all_global"	"data/ui/campaign ui/effect_bundles/bos_effect_growth.tga"	50
"bos_event_growth_all_local"	"data/ui/campaign ui/effect_bundles/bos_effect_growth.tga"	50
"bos_event_growth_mod_trade_ports"	"data/ui/campaign ui/effect_bundles/bos_effect_growth.tga"	50
"bos_event_happiness_global"	"data/ui/campaign ui/effect_bundles/bos_effect_public_order_positive.tga"	50
"bos_event_happiness_local"	"data/ui/campaign ui/effect_bundles/bos_effect_public_order_positive.tga"	50
"bos_event_happiness_samurai_global"	"data/ui/campaign ui/effect_bundles/bos_effect_public_order_positive.tga"	50
"bos_event_mod_xp_artillery"	"data/ui/campaign ui/effect_bundles/bos_effect_military_positive.tga"	50
"bos_event_mod_xp_rifles"	"data/ui/campaign ui/effect_bundles/bos_effect_military_positive.tga"	50
"bos_event_morale_mod_army"	"data/ui/campaign ui/effect_bundles/bos_effect_army_positive.tga"	50
"bos_event_morale_mod_navy"	"data/ui/campaign ui/effect_bundles/bos_effect_navy_positive"	50
"bos_event_recruitment_cost_mod_ships"	"data/ui/campaign ui/effect_bundles/bos_effect_navy_positive.tga"	50
"bos_event_recruitment_cost_shinsengumi_local"	"data/ui/campaign ui/effect_bundles/bos_effect_shinsengumi_positive.tga"	50
"bos_event_research_mod_both"	"data/ui/campaign ui/effect_bundles/bos_effect_technology_positive.tga"	50
"bos_event_research_mod_civil"	"data/ui/campaign ui/effect_bundles/bos_effect_technology_positive.tga"	50
"bos_event_research_mod_military"	"data/ui/campaign ui/effect_bundles/bos_effect_technology_positive.tga"	50
"bos_event_samurai_cost"	"data/ui/campaign ui/effect_bundles/bos_effect_traditional_infantry_melee_positive.tga"	50
"bos_event_unhappiness_local"	"data/ui/campaign ui/effect_bundles/bos_effect_public_order_negative.tga"	51
"bos_gdp_commerce"	"data/ui/campaign ui/effect_bundles/bos_effect_wealth.tga"	349
"bos_gdp_farm"	"data/ui/campaign ui/effect_bundles/bos_effect_wealth.tga"	353
"bos_gdp_industry"	"data/ui/campaign ui/effect_bundles/bos_effect_wealth.tga"	335
"bos_gdp_mine"	"data/ui/campaign ui/effect_bundles/bos_effect_wealth.tga"	320
"bos_gdp_port"	"data/ui/campaign ui/effect_bundles/bos_effect_wealth_positive.tga"	920
"bos_geisha_mod_action_cost_global"	"data/ui/campaign ui/effect_bundles/bos_effect_wealth_positive.tga"	100
"bos_geisha_mod_culture_chain"	"data/ui/campaign ui/effect_bundles/bos_effect_geisha_positive.tga"	100
"bos_geisha_mod_success"	"data/ui/campaign ui/effect_bundles/bos_effect_geisha_positive.tga"	332
"bos_general_army_charge_bonus"	"data/ui/campaign ui/effect_bundles/bos_effect_general_positive.tga"	50
"bos_general_attribute_command_all"	"data/ui/campaign ui/effect_bundles/bos_effect_general_positive.tga"	100
"bos_general_attribute_command_attack_all"	"data/ui/campaign ui/effect_bundles/bos_effect_general_positive.tga"	100
"bos_general_attribute_command_defend_all"	"data/ui/campaign ui/effect_bundles/bos_effect_general_positive.tga"	100
"bos_general_attribute_command_land_ambush"	"data/ui/campaign ui/effect_bundles/bos_effect_general_positive.tga"	50
"bos_general_enables_ramming"	"data/ui/campaign ui/effect_bundles/bos_effect_ramming.tga"	100
"bos_general_honourable"	"data/ui/campaign ui/effect_bundles/bos_effect_general_positive.tga"	100
"bos_general_mod_all_upkeep"	"data/ui/campaign ui/effect_bundles/bos_effect_wealth_positive.tga"	100
"bos_general_mod_ammunition"	"data/ui/campaign ui/effect_bundles/bos_effect_modern_infantry_ranged_positive.tga"	100
"bos_general_mod_army_accuracy"	"data/ui/campaign ui/effect_bundles/bos_effect_accuracy_positive.tga"	100
"bos_general_mod_army_armour"	"data/ui/campaign ui/effect_bundles/bos_effect_armour_positive.tga"	100
"bos_general_mod_army_reload_rate"	"data/ui/campaign ui/effect_bundles/bos_effect_army_positive.tga"	100
"bos_general_mod_army_stamina"	"data/ui/campaign ui/effect_bundles/bos_effect_seige_defence_positive.tga"	100
"bos_general_mod_aura"	"data/ui/campaign ui/effect_bundles/bos_effect_general_positive.tga"	100
"bos_general_mod_bodyguard_accuracy"	"data/ui/campaign ui/effect_bundles/bos_effect_accuracy_positive.tga"	50
"bos_general_mod_bodyguard_armour"	"data/ui/campaign ui/effect_bundles/bos_effect_armour_positive.tga"	50
"bos_general_mod_bodyguard_charge_bonus"	"data/ui/campaign ui/effect_bundles/bos_effect_charge_positive.tga"	100
"bos_general_mod_bodyguard_morale"	"data/ui/campaign ui/effect_bundles/bos_effect_morale_positive.tga"	50
"bos_general_mod_bodyguard_size"	"data/ui/campaign ui/effect_bundles/bos_effect_army_positive.tga"	50
"bos_general_mod_bombardment_range"	"data/ui/campaign ui/effect_bundles/bos_effect_coastal_defences_positive.tga"	100
"bos_general_mod_flagship_accuracy"	"data/ui/campaign ui/effect_bundles/bos_effect_accuracy_positive.tga"	100
"bos_general_mod_flagship_armour"	"data/ui/campaign ui/effect_bundles/bos_effect_navy_positive.tga"	100
"bos_general_mod_flagship_health"	"data/ui/campaign ui/effect_bundles/bos_effect_navy_positive.tga"	100
"bos_general_mod_flagship_morale"	"data/ui/campaign ui/effect_bundles/bos_effect_morale_positive.tga"	100
"bos_general_mod_land_unit_morale"	"data/ui/campaign ui/effect_bundles/bos_effect_morale.tga"	50
"bos_general_mod_navy_accuracy"	"data/ui/campaign ui/effect_bundles/bos_effect_accuracy_positive.tga"	100
"bos_general_mod_navy_armour"	"data/ui/campaign ui/effect_bundles/bos_effect_navy.tga"	100
"bos_general_mod_navy_broadsides"	"data/ui/campaign ui/effect_bundles/bos_effect_suppression_fire_positive.tga"	100
"bos_general_mod_navy_reload_rate"	"data/ui/campaign ui/effect_bundles/bos_effect_navy_positive.tga"	100
"bos_general_mod_ship_morale"	"data/ui/campaign ui/effect_bundles/bos_effect_morale.tga"	50
"bos_general_mod_trade_raiding"	"data/ui/campaign ui/effect_bundles/bos_effect_navy.tga"	100
"bos_general_rally_mod"	"data/ui/campaign ui/effect_bundles/bos_effect_morale_positive.tga"	50
"bos_general_resistance_bonus"	"data/ui/campaign ui/effect_bundles/bos_effect_public_order_positive.tga"	50
"bos_gentlemen_happiness_bonus"	"data/ui/campaign ui/effect_bundles/bos_effect_public_order_positive.tga"	50
"bos_happiness_character_modernisation"	"data/ui/campaign ui/effect_bundles/bos_effect_public_order.tga"	4
"bos_happy_culture_local"	"data/ui/campaign ui/effect_bundles/bos_effect_public_order_positive.tga"	334
"bos_ishinshishi_mod_action_cost_global"	"data/ui/campaign ui/effect_bundles/bos_effect_wealth_positive.tga"	200
"bos_ishinshishi_mod_conversion_global"	"data/ui/campaign ui/effect_bundles/bos_effect_imperial_allegiance_positive.tga"	100
"bos_ishinshishi_mod_imperial_unit_cost"	"data/ui/campaign ui/effect_bundles/bos_effect_modern_infantry_melee.tga"	100
"bos_ishinshishi_mod_imperial_unit_morale"	"data/ui/campaign ui/effect_bundles/bos_effect_imperial_allegiance_positive.tga"	1
"bos_ishinshishi_unhappiness_local"	"data/ui/campaign ui/effect_bundles/bos_effect_public_order_negative.tga"	100
"bos_land_recruitment_points"	"data/ui/campaign ui/effect_bundles/bos_effect_army.tga"	373
"bos_line_of_sight_mod"	"data/ui/campaign ui/effect_bundles/bos_effect_character_positive.tga"	50
"bos_looting_mod"	"data/ui/campaign ui/effect_bundles/bos_effect_wealth_positive.tga"	50
"bos_military_mission_american_building"	"data/ui/campaign ui/effect_bundles/bos_effect_construction_positive.tga"	10
"bos_military_mission_american_units"	"data/ui/campaign ui/effect_bundles/bos_effect_america_positive.tga"	20
"bos_military_mission_british_building"	"data/ui/campaign ui/effect_bundles/bos_effect_construction_positive.tga"	10
"bos_military_mission_british_units"	"data/ui/campaign ui/effect_bundles/bos_effect_britain_positive.tga"	20
"bos_military_mission_french_building"	"data/ui/campaign ui/effect_bundles/bos_effect_construction_positive.tga"	10
"bos_military_mission_french_units"	"data/ui/campaign ui/effect_bundles/bos_effect_france_positive.tga"	20
"bos_minister_agent_recruitment_cost_local"	"data/ui/campaign ui/effect_bundles/bos_effect_minister_positive.tga"	2
"bos_minister_agent_success_global"	"data/ui/campaign ui/effect_bundles/bos_effect_character_positive.tga"	1
"bos_minister_construction_cost_global"	"data/ui/campaign ui/effect_bundles/bos_effect_construction_positive.tga"	1
"bos_minister_conversion_global"	"data/ui/campaign ui/effect_bundles/bos_effect_allegiance_positive.tga"	3
"bos_minister_growth_global"	"data/ui/campaign ui/effect_bundles/bos_effect_growth_positive.tga"	1
"bos_minister_max_agent_cap_global"	"data/ui/campaign ui/effect_bundles/bos_effect_minister_positive.tga"	3
"bos_minister_morale_local"	"data/ui/campaign ui/effect_bundles/bos_effect_morale_positive.tga"	2
"bos_minister_recruitment_cost_global"	"data/ui/campaign ui/effect_bundles/bos_effect_army_positive.tga"	1
"bos_minister_replenishment_global"	"data/ui/campaign ui/effect_bundles/bos_effect_army_positive.tga"	3
"bos_minister_repression_local"	"data/ui/campaign ui/effect_bundles/bos_effect_public_order.tga"	2
"bos_minister_tax_local"	"data/ui/campaign ui/effect_bundles/bos_effect_wealth.tga"	2
"bos_minister_upkeep_global"	"data/ui/campaign ui/effect_bundles/bos_effect_wealth.tga"	3
"bos_mod_building_repair_cost"	"data/ui/campaign ui/effect_bundles/bos_effect_construction_positive.tga"	1
"bos_mod_charge_all_local"	"data/ui/campaign ui/effect_bundles/bos_effect_charge_positive.tga"	325
"bos_mod_recruitment_cost_land_all_local"	"data/ui/campaign ui/effect_bundles/bos_effect_army_positive.tga"	363
"bos_mod_unit_accuracy_all_local"	"data/ui/campaign ui/effect_bundles/bos_effect_accuracy_positive.tga"	327
"bos_mod_unit_armour_all_local"	"data/ui/campaign ui/effect_bundles/bos_effect_armour_positive.tga"	326
"bos_mod_unit_melee_all_local"	"data/ui/campaign ui/effect_bundles/bos_effect_melee_positive.tga"	360
"bos_mod_unit_morale_all_local"	"data/ui/campaign ui/effect_bundles/bos_effect_morale_positive.tga"	361
"bos_mod_unit_replenishment_all_local"	"data/ui/campaign ui/effect_bundles/bos_effect_army_positive.tga"	362
"bos_mod_unit_replenishment_local"	"data/ui/campaign ui/effect_bundles/bos_effect_army_positive.tga"	50
"bos_mod_xp_traditional_units"	"data/ui/campaign ui/effect_bundles/bos_effect_traditional_infantry_melee_positive.tga"	358
"bos_modernisation"	"data/ui/campaign ui/effect_bundles/bos_effect_modernisation.tga"	66
"bos_modernisation_happiness_mod"	"data/ui/campaign ui/effect_bundles/bos_effect_public_order_negative.tga"	1
"bos_movement_points_all_local"	"data/ui/campaign ui/effect_bundles/bos_effect_general_positive.tga"	50
"bos_movement_points_character"	"data/ui/campaign ui/effect_bundles/bos_effect_army.tga"	999
"bos_naval_recruitment_points"	"data/ui/campaign ui/effect_bundles/bos_effect_navy.tga"	351
"bos_naval_support_cooldown_mod"	"data/ui/campaign ui/effect_bundles/bos_effect_admiral_positive.tga"	50
"bos_naval_support_enable_projectile_1"	"data/ui/campaign ui/effect_bundles/bos_effect_admiral_positive.tga"	60
"bos_naval_support_enable_projectile_2"	"data/ui/campaign ui/effect_bundles/bos_effect_admiral_positive.tga"	60
"bos_naval_support_enable_projectile_3"	"data/ui/campaign ui/effect_bundles/bos_effect_accuracy_positive.tga"	60
"bos_naval_support_hits_mod"	"data/ui/campaign ui/effect_bundles/bos_effect_admiral_positive.tga"	30
"bos_naval_support_impact_mod"	"data/ui/campaign ui/effect_bundles/bos_effect_admiral_positive.tga"	20
"bos_naval_support_impact_window"	"data/ui/campaign ui/effect_bundles/bos_effect_admiral_positive.tga"	0
"bos_naval_support_radius_mod"	"data/ui/campaign ui/effect_bundles/bos_effect_accuracy_positive.tga"	20
"bos_naval_support_time_to_hit_mod"	"data/ui/campaign ui/effect_bundles/bos_effect_admiral_positive.tga"	40
"bos_naval_support_uses_mod"	"data/ui/campaign ui/effect_bundles/bos_effect_admiral_positive.tga"	10
"bos_personal_security"	"data/ui/campaign ui/effect_bundles/bos_effect_melee.tga"	50
"bos_railways"	"data/ui/campaign ui/effect_bundles/bos_effect_railways.tga"	1
"bos_realm_divide_imperial_1_banner"	"data/ui/campaign ui/effect_bundles/bos_effect_imperial_allegiance.tga"	50
"bos_realm_divide_imperial_2_rally"	"data/ui/campaign ui/effect_bundles/bos_effect_imperial_allegiance.tga"	100
"bos_realm_divide_imperial_3_convert"	"data/ui/campaign ui/effect_bundles/bos_effect_imperial_allegiance.tga"	150
"bos_realm_divide_self_1_summary"	"data/ui/campaign ui/effect_bundles/bos_effect_independant_allegiance.tga"	50
"bos_realm_divide_self_2_units_agents"	"data/ui/campaign ui/effect_bundles/bos_effect_independant_allegiance.tga"	100
"bos_realm_divide_self_3_propaganda_rebuild"	"data/ui/campaign ui/effect_bundles/bos_effect_independant_allegiance.tga"	150
"bos_realm_divide_self_4_propaganda_influence"	"data/ui/campaign ui/effect_bundles/bos_effect_independant_allegiance.tga"	200
"bos_realm_divide_shogun_1_banner"	"data/ui/campaign ui/effect_bundles/bos_effect_shogunate_allegiance.tga"	50
"bos_realm_divide_shogun_2_rally"	"data/ui/campaign ui/effect_bundles/bos_effect_shogunate_allegiance.tga"	100
"bos_realm_divide_shogun_3_convert"	"data/ui/campaign ui/effect_bundles/bos_effect_shogunate_allegiance.tga"	150
"bos_recruitment_cost_mod_category_artillery_global"	"data/ui/campaign ui/effect_bundles/bos_effect_artillery_positive.tga"	78
"bos_recruitment_cost_mod_category_artillery_local"	"data/ui/campaign ui/effect_bundles/bos_effect_artillery_positive.tga"	321
"bos_recruitment_cost_mod_category_naval_copper"	"data/ui/campaign ui/effect_bundles/bos_effect_copper_ship_positive.tga"	323
"bos_recruitment_time_mod_category_artillery"	"data/ui/campaign ui/effect_bundles/bos_effect_artillery_positive.tga"	322
"bos_recruitment_time_mod_category_naval_copper"	"data/ui/campaign ui/effect_bundles/bos_effect_copper_ship_positive.tga"	324
"bos_religion_conversion_no_non_state"	"data/ui/campaign ui/effect_bundles/bos_effect_allegiance.tga"	380
"bos_repression_building_local"	"data/ui/campaign ui/effect_bundles/bos_effect_public_order.tga"	336
"bos_resistance_to_bombardment"	"data/ui/campaign ui/effect_bundles/bos_effect_coastal_defences_positive.tga"	390
"bos_shinobi_mod_action_cost_global"	"data/ui/campaign ui/effect_bundles/bos_effect_wealth_positive.tga"	100
"bos_shinobi_mod_sabotage_army_casualties"	"data/ui/campaign ui/effect_bundles/bos_effect_army.tga"	100
"bos_shinsengumi_mod_action_cost_global"	"data/ui/campaign ui/effect_bundles/bos_effect_wealth_positive.tga"	100
"bos_shinsengumi_mod_conversion_global"	"data/ui/campaign ui/effect_bundles/bos_effect_shinsengumi_positive.tga"	100
"bos_shinsengumi_mod_shin_unit_morale"	"data/ui/campaign ui/effect_bundles/bos_effect_shogunate_allegiance_positive.tga"	100
"bos_shinsengumi_mod_shogunate_unit_cost"	"data/ui/campaign ui/effect_bundles/bos_effect_shogunate_allegiance_positive.tga"	100
"bos_siege_defence_gatling_gun"	"data/ui/campaign ui/effect_bundles/bos_effect_seige_defence_positive.tga"	396
"bos_siege_defence_gun_batteries"	"data/ui/campaign ui/effect_bundles/bos_effect_seige_defence_positive.tga"	397
"bos_siege_defence_matchlock"	"data/ui/campaign ui/effect_bundles/bos_effect_seige_defence_positive.tga"	395
"bos_tax_bonus_building"	"data/ui/campaign ui/effect_bundles/bos_effect_wealth.tga"	350
"bos_tech_ability_banzai"	"data/ui/campaign ui/effect_bundles/bos_tech_enable_banzai.tga"	1
"bos_tech_ability_blinding_grenades"	"data/ui/campaign ui/effect_bundles/bos_tech_enable_blinding_grenades.tga"	1
"bos_tech_ability_enable_advanced_segment_shell"	"data/ui/campaign ui/effect_bundles/bos_effect_advanced_segment_shell.tga"	1
"bos_tech_ability_enable_common_shell"	"data/ui/campaign ui/effect_bundles/bos_effect_common_shell.tga"	1
"bos_tech_ability_enable_kneel_fire"	"data/ui/campaign ui/effect_bundles/bos_effect_kneel_fire.tga"	1
"bos_tech_ability_enable_ramming"	"data/ui/campaign ui/effect_bundles/bos_effect_ramming.tga"	1
"bos_tech_ability_enable_segment_shell"	"data/ui/campaign ui/effect_bundles/bos_effect_segment_shell.tga"	1
"bos_tech_ability_enable_suppression_fire"	"data/ui/campaign ui/effect_bundles/bos_effect_suppression_fire_positive.tga"	1
"bos_tech_ability_enable_torpedo"	"data/ui/campaign ui/effect_bundles/bos_effect_torpedo.tga"	1
"bos_tech_ability_fire_arrows"	"data/ui/campaign ui/effect_bundles/bos_tech_enable_fire_arrows.tga"	1
"bos_tech_admin_cost_mod"	"data/ui/campaign ui/effect_bundles/bos_effect_wealth_positive.tga"	50
"bos_tech_agent_action_cost_mod_foreign_veteran"	"data/ui/campaign ui/effect_bundles/bos_effect_foreign_veteran_positive.tga"	7001
"bos_tech_agent_action_cost_mod_geisha"	"data/ui/campaign ui/effect_bundles/bos_effect_geisha_positive.tga"	7001
"bos_tech_agent_action_cost_mod_ishin_shishi"	"data/ui/campaign ui/effect_bundles/bos_effect_ishin_shishi_positive.tga"	7001
"bos_tech_agent_action_cost_mod_shinobi"	"data/ui/campaign ui/effect_bundles/bos_effect_ninja_positive.tga"	7001
"bos_tech_agent_action_cost_mod_shinsengumi"	"data/ui/campaign ui/effect_bundles/bos_effect_shinsengumi_positive.tga"	7001
"bos_tech_agent_foreign_veteran_success_mod"	"data/ui/campaign ui/effect_bundles/bos_effect_foreign_veteran_positive.tga"	51
"bos_tech_agent_geisha_success_mod"	"data/ui/campaign ui/effect_bundles/bos_effect_geisha_positive.tga"	51
"bos_tech_agent_ishin_shishi_success_mod"	"data/ui/campaign ui/effect_bundles/bos_effect_ishin_shishi_positive.tga"	51
"bos_tech_agent_shinobi_success_mod"	"data/ui/campaign ui/effect_bundles/bos_effect_ninja_positive.tga"	51
"bos_tech_agent_shinsengumi_success_mod"	"data/ui/campaign ui/effect_bundles/bos_effect_shinsengumi_positive.tga"	51
"bos_tech_building_cost_mod"	"data/ui/campaign ui/effect_bundles/bos_effect_construction_positive.tga"	206
"bos_tech_building_farm_cost_mod"	"data/ui/campaign ui/effect_bundles/bos_effect_construction_positive.tga"	1
"bos_tech_building_port_cost_mod"	"data/ui/campaign ui/effect_bundles/bos_effect_construction_positive.tga"	1
"bos_tech_building_settlement_cost_mod"	"data/ui/campaign ui/effect_bundles/bos_effect_construction_positive.tga"	1
"bos_tech_clan_daimyo_honour_mod"	"data/ui/campaign ui/effect_bundles/bos_effect_daimyo_positive.tga"	1
"bos_tech_clan_income_farm_mod"	"data/ui/campaign ui/effect_bundles/bos_effect_wealth_positive.tga"	1
"bos_tech_clan_income_tax_mod"	"data/ui/campaign ui/effect_bundles/bos_effect_wealth_positive.tga"	1
"bos_tech_clan_income_trade_mod"	"data/ui/campaign ui/effect_bundles/bos_effect_trade_positive.tga"	1
"bos_tech_conversion_state_religion"	"data/ui/campaign ui/effect_bundles/bos_effect_allegiance.tga"	9999
"bos_tech_general_aoe_mod"	"data/ui/campaign ui/effect_bundles/bos_effect_general_positive.tga"	1
"bos_tech_general_loyalty_bonus"	"data/ui/campaign ui/effect_bundles/bos_effect_general_positive.tga"	1
"bos_tech_modernisation_negative"	"data/ui/campaign ui/effect_bundles/bos_effect_modernisation_negative.tga"	44
"bos_tech_modernisation_positive"	"data/ui/campaign ui/effect_bundles/bos_effect_modernisation_positive.tga"	77
"bos_tech_naval_accuracy_mod"	"data/ui/campaign ui/effect_bundles/bos_effect_accuracy_positive.tga"	50
"bos_tech_regional_happiness_mod"	"data/ui/campaign ui/effect_bundles/bos_effect_public_order_positive.tga"	1
"bos_tech_regional_repression_mod"	"data/ui/campaign ui/effect_bundles/bos_effect_public_order.tga"	1
"bos_tech_regional_town_wealth_mod"	"data/ui/campaign ui/effect_bundles/bos_effect_wealth_positive.tga"	1
"bos_tech_unit_cannon_accuracy_mod"	"data/ui/campaign ui/effect_bundles/bos_effect_accuracy_positive.tga"	0
"bos_tech_unit_cavalry_cost_mod"	"data/ui/campaign ui/effect_bundles/bos_effect_army_positive.tga"	1
"bos_tech_unit_enable_night_battles_naval"	"data/ui/campaign ui/effect_bundles/bos_effect_night_battle.tga"	1
"bos_tech_unit_general_unit_switch_mod"	"data/ui/campaign ui/effect_bundles/bos_effect_general_positive.tga"	1
"bos_tech_unit_guerrilla_unit_cap_mod"	"data/ui/campaign ui/effect_bundles/bos_effect_army.tga"	0
"bos_tech_unit_kisho_unit_cap_mod"	"data/ui/campaign ui/effect_bundles/bos_effect_ninja.tga"	0
"bos_tech_unit_land_ammo_mod"	"data/ui/campaign ui/effect_bundles/bos_effect_modern_infantry_ranged_positive.tga"	50
"bos_tech_unit_land_charge_bonus_mod"	"data/ui/campaign ui/effect_bundles/bos_effect_charge_positive.tga"	1
"bos_tech_unit_land_cost_mod"	"data/ui/campaign ui/effect_bundles/bos_effect_army_positive.tga"	1
"bos_tech_unit_land_def_mod"	"data/ui/campaign ui/effect_bundles/bos_effect_armour_positive.tga"	1
"bos_tech_unit_land_morale_mod"	"data/ui/campaign ui/effect_bundles/bos_effect_morale_positive.tga"	1
"bos_tech_unit_land_movement_mod"	"data/ui/campaign ui/effect_bundles/bos_effect_army_positive.tga"	1
"bos_tech_unit_land_run_speed_mod"	"data/ui/campaign ui/effect_bundles/bos_effect_army_positive.tga"	1
"bos_tech_unit_modern_accuracy_mod"	"data/ui/campaign ui/effect_bundles/bos_effect_accuracy_positive.tga"	1
"bos_tech_unit_modern_cost_mod"	"data/ui/campaign ui/effect_bundles/bos_effect_army_positive.tga"	1
"bos_tech_unit_modern_morale_mod"	"data/ui/campaign ui/effect_bundles/bos_effect_morale_positive.tga"	1
"bos_tech_unit_naval_movement_mod"	"data/ui/campaign ui/effect_bundles/bos_effect_navy_positive.tga"	1
"bos_tech_unit_replenish_mod"	"data/ui/campaign ui/effect_bundles/bos_effect_army_positive.tga"	1
"bos_tech_unit_ship_battle_speed_mod"	"data/ui/campaign ui/effect_bundles/bos_effect_navy_positive.tga"	1
"bos_tech_unit_ship_cost_mod"	"data/ui/campaign ui/effect_bundles/bos_effect_navy_positive.tga"	1
"bos_tech_unit_ship_recruitment_time_mod"	"data/ui/campaign ui/effect_bundles/bos_effect_navy_positive.tga"	1
"bos_tech_unit_ship_upkeep_cost_mod"	"data/ui/campaign ui/effect_bundles/bos_effect_navy.tga"	1
"bos_tech_unit_trad_cost_mod"	"data/ui/campaign ui/effect_bundles/bos_effect_army_positive.tga"	1
"bos_tech_unit_trad_morale_mod"	"data/ui/campaign ui/effect_bundles/bos_effect_morale_positive.tga"	1
"bos_tech_unit_trad_xp_mod"	"data/ui/campaign ui/effect_bundles/bos_effect_army_positive.tga"	1
"bos_tech_unit_upkeep_mod"	"data/ui/campaign ui/effect_bundles/bos_effect_wealth_positive.tga"	1
"bos_trade_income_mod"	"data/ui/campaign ui/effect_bundles/bos_effect_trade_positive.tga"	329
"bos_trade_routes_mod_max_sea"	"data/ui/campaign ui/effect_bundles/bos_effect_trade_positive.tga"	352
"bos_traditionalism"	"data/ui/campaign ui/effect_bundles/bos_effect_modernisation_negative.tga"	55
"bos_tw_growth_commerce"	"data/ui/campaign ui/effect_bundles/bos_effect_growth.tga"	330
"bos_tw_growth_industry"	"data/ui/campaign ui/effect_bundles/bos_effect_growth.tga"	348
"bos_unit_modern_cost_mod_global"	"data/ui/campaign ui/effect_bundles/bos_effect_army.tga"	896
"bos_unit_modern_cost_mod_local"	"data/ui/campaign ui/effect_bundles/bos_effect_army.tga"	985
"bos_unit_naval_battle_movement_mod"	"data/ui/campaign ui/effect_bundles/bos_effect_navy_positive.tga"	0
"bos_unit_ship_cost_mod_local"	"data/ui/campaign ui/effect_bundles/bos_effect_navy_positive.tga"	69
"bos_unit_traditional_cost_mod_global"	"data/ui/campaign ui/effect_bundles/bos_effect_army_positive.tga"	66
"bos_unit_traditional_cost_mod_local"	"data/ui/campaign ui/effect_bundles/bos_effect_army_positive.tga"	55
"bos_veteran_mod_action_cost_global"	"data/ui/campaign ui/effect_bundles/bos_effect_wealth_positive.tga"	100
"bos_veteran_mod_artillery_reload_rate"	"data/ui/campaign ui/effect_bundles/bos_effect_artillery_positive.tga"	100
"bos_veteran_mod_harass_army_casualties"	"data/ui/campaign ui/effect_bundles/bos_effect_army.tga"	100
"bos_veteran_mod_marksmanship_all"	"data/ui/campaign ui/effect_bundles/bos_effect_accuracy_positive.tga"	100
"bos_veteran_mod_marksmanship_inf_cav"	"data/ui/campaign ui/effect_bundles/bos_effect_accuracy_positive.tga"	100
"bos_veteran_mod_marksmanship_rifles"	"data/ui/campaign ui/effect_bundles/bos_effect_accuracy_positive.tga"	100
"bos_veteran_mod_melee_all"	"data/ui/campaign ui/effect_bundles/bos_effect_modern_infantry_melee_positive.tga"	100
"bos_veteran_mod_melee_ranged_infantry"	"data/ui/campaign ui/effect_bundles/bos_effect_modern_infantry_melee_positive.tga"	0
"bos_veteran_mod_melee_rifles"	"data/ui/campaign ui/effect_bundles/bos_effect_modern_infantry_melee_positive.tga"	100
"bos_veteran_mod_reload_rate_all"	"data/ui/campaign ui/effect_bundles/bos_effect_modern_infantry_ranged_positive.tga"	100
"bos_veteran_mod_reload_rate_rifles"	"data/ui/campaign ui/effect_bundles/bos_effect_modern_infantry_ranged_positive.tga"	100
"bos_western_port_hidden"	"data/ui/campaign ui/effect_bundles/bos_effect_trade_positive.tga"	1
"building_construction_time_mod_all"	"data/ui/campaign ui/effect_bundles/effect_construction.tga"	100
"building_construction_time_mod_all_global"	"data/ui/campaign ui/effect_bundles/effect_construction.tga"	100
"building_cost_mod_all"	"data/ui/campaign ui/effect_bundles/effect_wealth.tga"	207
"building_cost_mod_all_global"	"data/ui/campaign ui/effect_bundles/effect_wealth.tga"	206
"building_cost_mod_local"	"data/ui/campaign ui/effect_bundles/effect_wealth.tga"	999
"building_mod_income_farms"	"data/ui/campaign ui/effect_bundles/effect_wealth_positive.tga"	5
"campaign_map_stealth"	"data/ui/campaign ui/effect_bundles/effect_army.tga"	1
"castle_slot_addition"	"data/ui/campaign ui/effect_bundles/effect_construction_positive.tga"	2347
"character_death_chance_turn_end"	"data/ui/campaign ui/effect_bundles/effect_character.tga"	1
"charge_bonus_mod"	"data/ui/campaign ui/effect_bundles/effect_army.tga"	999
"clan_trait_chosokabe_cheap_foot_archers"	"data/ui/campaign ui/effect_bundles/effect_chosokabe.tga"	5
"clan_trait_chosokabe_superio_foot_archers"	"data/ui/campaign ui/effect_bundles/effect_chosokabe.tga"	1
"clan_trait_chosokabe_superior_farms"	"data/ui/campaign ui/effect_bundles/effect_chosokabe.tga"	10
"clan_trait_date_charge_bonus"	"data/ui/campaign ui/effect_bundles/effect_date.tga"	10
"clan_trait_date_cheap_nodachi"	"data/ui/campaign ui/effect_bundles/effect_date.tga"	5
"clan_trait_date_superior_nodachi"	"data/ui/campaign ui/effect_bundles/effect_date.tga"	1
"clan_trait_hattori_guerrilla_deployment"	"data/ui/campaign ui/effect_bundles/effect_hattori.tga"	10
"clan_trait_hattori_stealthy_units"	"data/ui/campaign ui/effect_bundles/effect_hattori.tga"	10
"clan_trait_hojo_cheap_castle"	"data/ui/campaign ui/effect_bundles/effect_hojo.tga"	10
"clan_trait_hojo_cheap_siege_units"	"data/ui/campaign ui/effect_bundles/effect_hojo.tga"	5
"clan_trait_hojo_superior_siege_units"	"data/ui/campaign ui/effect_bundles/effect_hojo.tga"	1
"clan_trait_ikko_ashigaru"	"data/ui/campaign ui/effect_bundles/effect_ikko_ikki.tga"	2
"clan_trait_ikko_general_convert"	"data/ui/campaign ui/effect_bundles/effect_ikko_ikki.tga"	3
"clan_trait_ikko_no_metsuke"	"data/ui/campaign ui/effect_bundles/effect_ikko_ikki.tga"	1
"clan_trait_ikko_warrior_monks"	"data/ui/campaign ui/effect_bundles/effect_ikko_ikki.tga"	4
"clan_trait_mori_cheap_ship"	"data/ui/campaign ui/effect_bundles/effect_mori.tga"	5
"clan_trait_mori_ship_movement"	"data/ui/campaign ui/effect_bundles/effect_mori.tga"	10
"clan_trait_mori_superior_ship"	"data/ui/campaign ui/effect_bundles/effect_mori.tga"	1
"clan_trait_oda_ashigaru_morale_bonus"	"data/ui/campaign ui/effect_bundles/effect_oda.tga"	10
"clan_trait_oda_cheap_ashigaru"	"data/ui/campaign ui/effect_bundles/effect_oda.tga"	5
"clan_trait_otomo_cheap_gunpowder_units"	"data/ui/campaign ui/effect_bundles/effect_otomo.tga"	1
"clan_trait_otomo_cheap_missionary_actions"	"data/ui/campaign ui/effect_bundles/effect_otomo.tga"	2
"clan_trait_otomo_faster_import_matchlock"	"data/ui/campaign ui/effect_bundles/effect_otomo.tga"	4
"clan_trait_otomo_improved_conversion"	"data/ui/campaign ui/effect_bundles/effect_otomo.tga"	5
"clan_trait_otomo_superior_missionaries"	"data/ui/campaign ui/effect_bundles/effect_otomo.tga"	3
"clan_trait_shimazu_cheap_samurai"	"data/ui/campaign ui/effect_bundles/effect_shimazu.tga"	5
"clan_trait_shimazu_increased_loyalty"	"data/ui/campaign ui/effect_bundles/effect_shimazu.tga"	10
"clan_trait_shimazu_superior_katana_hero"	"data/ui/campaign ui/effect_bundles/effect_shimazu.tga"	1
"clan_trait_shimazu_superior_katana_samurai"	"data/ui/campaign ui/effect_bundles/effect_shimazu.tga"	1
"clan_trait_takeda_cavalry_morale_bonus"	"data/ui/campaign ui/effect_bundles/effect_takeda.tga"	10
"clan_trait_takeda_cheap_cavalry"	"data/ui/campaign ui/effect_bundles/effect_takeda.tga"	5
"clan_trait_takeda_superior_cavalry"	"data/ui/campaign ui/effect_bundles/effect_takeda.tga"	1
"clan_trait_tokugawa_cheap_battlefield_ninja"	"data/ui/campaign ui/effect_bundles/effect_tokugawa.tga"	5
"clan_trait_tokugawa_diplomacy_bonus"	"data/ui/campaign ui/effect_bundles/effect_tokugawa.tga"	10
"clan_trait_tokugawa_superior_battlefield_ninja"	"data/ui/campaign ui/effect_bundles/effect_tokugawa.tga"	1
"clan_trait_tokugawa_superior_metsuke"	"data/ui/campaign ui/effect_bundles/effect_tokugawa.tga"	1
"clan_trait_uesugi_cheap_warrior_monks"	"data/ui/campaign ui/effect_bundles/effect_uesugi.tga"	5
"clan_trait_uesugi_superior_monks"	"data/ui/campaign ui/effect_bundles/effect_uesugi.tga"	1
"clan_trait_uesugi_superior_warrior_monks"	"data/ui/campaign ui/effect_bundles/effect_uesugi.tga"	1
"clan_trait_uesugi_trade_bonus"	"data/ui/campaign ui/effect_bundles/effect_uesugi.tga"	10
"commodity_prod_bos_coal"	"data/ui/campaign ui/effect_bundles/bos_effect_commodity_coal.tga"	413
"commodity_prod_bos_copper"	"data/ui/campaign ui/effect_bundles/bos_effect_commodity_copper.tga"	412
"commodity_prod_bos_cotton"	"data/ui/campaign ui/effect_bundles/bos_effect_commodity_cotton.tga"	411
"commodity_prod_bos_iron"	"data/ui/campaign ui/effect_bundles/bos_effect_commodity_iron.tga"	409
"commodity_prod_bos_machines"	"data/ui/campaign ui/effect_bundles/bos_effect_commodity_machines.tga"	414
"commodity_prod_bos_silk"	"data/ui/campaign ui/effect_bundles/bos_effect_commodity_silk.tga"	410
"commodity_prod_bos_tea"	"data/ui/campaign ui/effect_bundles/bos_effect_commodity_tea.tga"	415
"commodity_prod_sho_cotton"	"data/ui/campaign ui/effect_bundles/effect_resource.tga"	408
"commodity_prod_sho_crafts"	"data/ui/campaign ui/effect_bundles/effect_resource.tga"	407
"commodity_prod_sho_horses"	"data/ui/campaign ui/effect_bundles/effect_resource.tga"	401
"commodity_prod_sho_iron"	"data/ui/campaign ui/effect_bundles/effect_resource.tga"	400
"commodity_prod_sho_silk"	"data/ui/campaign ui/effect_bundles/effect_resource.tga"	406
"commodity_prod_sho_spice"	"data/ui/campaign ui/effect_bundles/effect_resource.tga"	404
"commodity_prod_sho_stone"	"data/ui/campaign ui/effect_bundles/effect_resource.tga"	402
"commodity_prod_sho_wood"	"data/ui/campaign ui/effect_bundles/effect_resource.tga"	403
"conversion_buddhist"	"data/ui/campaign ui/effect_bundles/effect_buddhism_positive.tga"	608
"conversion_buddhist_osmosis"	"data/ui/campaign ui/effect_bundles/effect_buddhism_positive.tga"	652
"conversion_catholic"	"data/ui/campaign ui/effect_bundles/effect_christianity_positive.tga"	607
"conversion_catholic_osmosis"	"data/ui/campaign ui/effect_bundles/effect_christianity_positive.tga"	651
"conversion_ikko"	"data/ui/campaign ui/effect_bundles/effect_ikko_positive.tga"	609
"conversion_ikko_osmosis"	"data/ui/campaign ui/effect_bundles/effect_ikko_positive.tga"	650
"conversion_state_religion"	"data/ui/campaign ui/effect_bundles/effect_religion_positive.tga"	9999
"conversion_state_religion_local"	"data/ui/campaign ui/effect_bundles/effect_religion_positive.tga"	999
"diplomacy_bonus_emissaries"	"data/ui/campaign ui/effect_bundles/effect_diplomacy.tga"	3
"diplomacy_bonus_enlightenment"	"data/ui/campaign ui/effect_bundles/effect_diplomacy.tga"	2
"diplomacy_bonus_faction_leader"	"data/ui/campaign ui/effect_bundles/effect_diplomacy.tga"	2
"diplomatic_bonus"	"data/ui/campaign ui/effect_bundles/effect_diplomacy.tga"	5
"diplomatic_bonus_mod"	"data/ui/campaign ui/effect_bundles/effect_diplomacy.tga"	999
"disband_cashback"	"data/ui/campaign ui/pips/effect_admiral.tga"	0
"enable_inspire_unit"	"data/ui/campaign ui/effect_bundles/effect_general.tga"	715
"enable_night_battles"	"data/ui/campaign ui/effect_bundles/effect_night_battle.tga"	999
"enable_night_battles_naval"	"data/ui/campaign ui/effect_bundles/effect_night_battle.tga"	1
"escape_chance_action_mod"	"data/ui/campaign ui/effect_bundles/effect_character.tga"	88
"escape_chance_mod"	"data/ui/campaign ui/effect_bundles/effect_character.tga"	999
"export_capacity_port"	"data/ui/campaign ui/effect_bundles/bos_effect_trade_positive.tga"	13
"export_capacity_road"	"data/ui/campaign ui/effect_bundles/bos_effect_trade_positive.tga"	13
"food_consumption"	"data/ui/campaign ui/effect_bundles/effect_food_negative.tga"	68
"food_consumption_event_disaster"	"data/ui/campaign ui/effect_bundles/effect_food_negative.tga"	912
"food_provision"	"data/ui/campaign ui/effect_bundles/effect_food_positive.tga"	68
"gdp_farm"	"data/ui/campaign ui/effect_bundles/effect_wealth.tga"	921
"gdp_industry"	"data/ui/campaign ui/effect_bundles/effect_wealth.tga"	922
"gdp_mine"	"data/ui/campaign ui/effect_bundles/effect_wealth.tga"	919
"gdp_mod_all"	"data/ui/campaign ui/effect_bundles/effect_wealth.tga"	923
"gdp_mod_all_local"	"data/ui/campaign ui/effect_bundles/effect_wealth.tga"	923
"gdp_mod_buildings_global"	"data/ui/campaign ui/effect_bundles/effect_wealth.tga"	912
"gdp_mod_buildings_local"	"data/ui/campaign ui/effect_bundles/effect_wealth.tga"	911
"gdp_mod_farms"	"data/ui/campaign ui/effect_bundles/effect_wealth.tga"	912
"gdp_mod_farms_global"	"data/ui/campaign ui/effect_bundles/effect_wealth.tga"	912
"gdp_mod_mines"	"data/ui/campaign ui/effect_bundles/effect_wealth.tga"	916
"gdp_mod_population_global"	"data/ui/campaign ui/effect_bundles/effect_wealth.tga"	913
"gdp_mod_population_local"	"data/ui/campaign ui/effect_bundles/effect_wealth.tga"	912
"gdp_mod_ports"	"data/ui/campaign ui/effect_bundles/effect_wealth.tga"	918
"gdp_mod_province_capital"	"data/ui/campaign ui/effect_bundles/effect_wealth.tga"	999
"gdp_port"	"data/ui/campaign ui/effect_bundles/effect_wealth.tga"	920
"gem_agent_attribute_cunning_conversion"	"data/ui/campaign ui/effect_bundles/effect_metsuke_positive.tga"	500
"gem_agent_attribute_cunning_payoff"	"data/ui/campaign ui/effect_bundles/effect_metsuke_positive.tga"	500
"gem_agent_attribute_cunning_request_allegiance"	"data/ui/campaign ui/effect_bundles/effect_metsuke_positive.tga"	500
"gem_agent_attribute_dancer_entertain_general"	"data/ui/campaign ui/effect_bundles/effect_geisha_positive.tga"	500
"gem_agent_attribute_dancer_entertain_nobles"	"data/ui/campaign ui/effect_bundles/effect_geisha_positive.tga"	500
"gem_agent_attribute_dancer_seduce"	"data/ui/campaign ui/effect_bundles/effect_geisha_positive.tga"	500
"gem_agent_attribute_dancer_stalling"	"data/ui/campaign ui/effect_bundles/effect_geisha_positive.tga"	5
"gem_agent_attribute_subterfuge_subvert_army"	"data/ui/campaign ui/effect_bundles/effect_subterfuge_positive.tga"	500
"gem_agent_attribute_zeal_indoctrinate"	"data/ui/campaign ui/effect_bundles/effect_religion_positive.tga"	650
"gem_agent_availability_quality_dancer"	"data/ui/campaign ui/effect_bundles/effect_geisha.tga"	1
"gem_agent_availability_quality_inspector"	"data/ui/campaign ui/effect_bundles/effect_metsuke.tga"	1
"gem_agent_availability_quality_monk"	"data/ui/campaign ui/effect_bundles/effect_monk.tga"	1
"gem_agent_availability_quality_spy"	"data/ui/campaign ui/effect_bundles/effect_ninja.tga"	1
"gem_agent_cap_dancer"	"data/ui/campaign ui/effect_bundles/effect_geisha.tga"	3567
"gem_agent_cap_inspector"	"data/ui/campaign ui/effect_bundles/effect_metsuke.tga"	3567
"gem_agent_cap_monk"	"data/ui/campaign ui/effect_bundles/effect_monk.tga"	3567
"gem_agent_cap_scout"	"data/ui/campaign ui/effect_bundles/effect_ninja.tga"	3567
"gem_agent_dancer_happiness_bonus"	"data/ui/campaign ui/effect_bundles/effect_character.tga"	900
"gem_agent_spy_stealth_mod"	"data/ui/campaign ui/effect_bundles/effect_ninja.tga"	50
"gem_agent_stealth_detection_mod"	"data/ui/campaign ui/effect_bundles/effect_character.tga"	500
"gem_agent_xp_mod_dancer"	"data/ui/campaign ui/effect_bundles/effect_geisha.tga"	9999
"gem_agent_xp_mod_inspector"	"data/ui/campaign ui/effect_bundles/effect_army.tga"	9998
"gem_agent_xp_mod_monk"	"data/ui/campaign ui/effect_bundles/effect_monk.tga"	3
"gem_agent_xp_mod_scout"	"data/ui/campaign ui/effect_bundles/effect_ninja.tga"	2
"gem_castle_walls_level_1"	"data/ui/campaign ui/effect_bundles/effect_construction_positive.tga"	1
"gem_castle_walls_level_2"	"data/ui/campaign ui/effect_bundles/effect_construction_positive.tga"	1
"gem_castle_walls_level_3"	"data/ui/campaign ui/effect_bundles/effect_construction_positive.tga"	1
"gem_clan_trait_fujiwara_haraizumi_inspector_action"	"data/ui/campaign ui/effect_bundles/gempei_effect_hiraizumi_fujiwara.tga"	30
"gem_clan_trait_fujiwara_haraizumi_inspector_succes"	"data/ui/campaign ui/effect_bundles/gempei_effect_hiraizumi_fujiwara.tga"	20
"gem_clan_trait_fujiwara_haraizumi_tax"	"data/ui/campaign ui/effect_bundles/gempei_effect_hiraizumi_fujiwara.tga"	10
"gem_clan_trait_fujiwara_haraizumi_technology"	"data/ui/campaign ui/effect_bundles/gempei_effect_hiraizumi_fujiwara.tga"	0
"gem_clan_trait_fujiwara_kubota_levy_cost_increase"	"data/ui/campaign ui/effect_bundles/gempei_effect_kubota_fujiwara_negative.tga"	30
"gem_clan_trait_fujiwara_kubota_research"	"data/ui/campaign ui/effect_bundles/gempei_effect_kubota_fujiwara.tga"	10
"gem_clan_trait_fujiwara_kubota_technologies"	"data/ui/campaign ui/effect_bundles/gempei_effect_kubota_fujiwara.tga"	0
"gem_clan_trait_fujiwara_kubota_warrior_monk"	"data/ui/campaign ui/effect_bundles/gempei_effect_kubota_fujiwara.tga"	20
"gem_clan_trait_minamoto_kamakura_reload"	"data/ui/campaign ui/effect_bundles/gempei_effect_kamakura_minamoto.tga"	20
"gem_clan_trait_minamoto_kamakura_research"	"data/ui/campaign ui/effect_bundles/gempei_effect_kamakura_minamoto.tga"	10
"gem_clan_trait_minamoto_kamakura_technology"	"data/ui/campaign ui/effect_bundles/gempei_effect_kamakura_minamoto.tga"	0
"gem_clan_trait_minamoto_kamakura_upkeep"	"data/ui/campaign ui/effect_bundles/gempei_effect_kamakura_minamoto.tga"	30
"gem_clan_trait_minamoto_kiso_campaign_movement"	"data/ui/campaign ui/effect_bundles/gempei_effect_kiso_minamoto.tga"	10
"gem_clan_trait_minamoto_kiso_negative_research"	"data/ui/campaign ui/effect_bundles/gempei_effect_kiso_minamoto_negative.tga"	20
"gem_clan_trait_minamoto_kiso_recruitment_mod"	"data/ui/campaign ui/effect_bundles/gempei_effect_kiso_minamoto.tga"	30
"gem_clan_trait_minamoto_kiso_technology"	"data/ui/campaign ui/effect_bundles/gempei_effect_kiso_minamoto.tga"	0
"gem_clan_trait_taira_fukuhara_armour"	"data/ui/campaign ui/effect_bundles/gempei_effect_fukuhara_taira.tga"	20
"gem_clan_trait_taira_fukuhara_regions"	"data/ui/campaign ui/effect_bundles/gempei_effect_fukuhara_taira.tga"	10
"gem_clan_trait_taira_fukuhara_technologies"	"data/ui/campaign ui/effect_bundles/gempei_effect_fukuhara_taira.tga"	0
"gem_clan_trait_taira_fukuhara_upkeep"	"data/ui/campaign ui/effect_bundles/gempei_effect_fukuhara_taira.tga"	30
"gem_clan_trait_taira_yashima_ship_movement"	"data/ui/campaign ui/effect_bundles/gempei_effect_yashima_taira.tga"	30
"gem_clan_trait_taira_yashima_ship_upkeep"	"data/ui/campaign ui/effect_bundles/gempei_effect_yashima_taira.tga"	20
"gem_clan_trait_taira_yashima_technologies"	"data/ui/campaign ui/effect_bundles/gempei_effect_yashima_taira.tga"	0
"gem_clan_trait_taira_yashima_trade"	"data/ui/campaign ui/effect_bundles/gempei_effect_yashima_taira.tga"	10
"gem_clan_trait_unit_xp_mod"	"data/ui/campaign ui/effect_bundles/effect_army_positive.tga"	0
"gem_commodity_prod_crafts"	"data/ui/campaign ui/effect_bundles/effect_resource.tga"	1
"gem_commodity_prod_incense"	"data/ui/campaign ui/effect_bundles/effect_resource.tga"	1
"gem_commodity_prod_iron"	"data/ui/campaign ui/effect_bundles/effect_resource.tga"	1
"gem_commodity_prod_silk"	"data/ui/campaign ui/effect_bundles/effect_resource.tga"	1
"gem_commodity_prod_texts"	"data/ui/campaign ui/effect_bundles/effect_resource.tga"	1
"gem_commodity_prod_wood"	"data/ui/campaign ui/effect_bundles/effect_resource.tga"	1
"gem_conversion_clan_female"	"data/ui/campaign ui/effect_bundles/effect_daimyo_positive.tga"	500
"gem_conversion_clan_influence"	"data/ui/campaign ui/effect_bundles/effect_daimyo_positive.tga"	999
"gem_conversion_clan_influence_gem_fujiwara"	"data/ui/campaign ui/effect_bundles/gempei_effect_hiraizumi_fujiwara.tga"	999
"gem_conversion_clan_influence_gem_minamoto"	"data/ui/campaign ui/effect_bundles/gempei_effect_kamakura_minamoto.tga"	999
"gem_conversion_clan_influence_gem_taira"	"data/ui/campaign ui/effect_bundles/gempei_effect_fukuhara_taira.tga"	999
"gem_conversion_clan_influence_osmosis_gem_fujiwara"	"data/ui/campaign ui/effect_bundles/gempei_effect_hiraizumi_fujiwara.tga"	9998
"gem_conversion_clan_influence_osmosis_gem_minamoto"	"data/ui/campaign ui/effect_bundles/gempei_effect_kamakura_minamoto.tga"	9998
"gem_conversion_clan_influence_osmosis_gem_taira"	"data/ui/campaign ui/effect_bundles/gempei_effect_fukuhara_taira.tga"	9998
"gem_conversion_clan_male"	"data/ui/campaign ui/effect_bundles/effect_daimyo_positive.tga"	500
"gem_conversion_no_non_state"	"data/ui/campaign ui/effect_bundles/effect_daimyo_positive.tga"	3
"gem_enables_cavalry_recruitment"	"data/ui/campaign ui/effect_bundles/effect_cavalry.tga"	5
"gem_general_accuracy_bonus"	"data/ui/campaign ui/effect_bundles/effect_archer.tga"	155
"gem_general_army_charge_bonus"	"data/ui/campaign ui/effect_bundles/effect_general.tga"	50
"gem_general_army_melee_attack_bonus"	"data/ui/campaign ui/effect_bundles/effect_general.tga"	50
"gem_general_army_melee_defence_bonus"	"data/ui/campaign ui/effect_bundles/effect_general.tga"	50
"gem_general_attribute_command_all_situation"	"data/ui/campaign ui/effect_bundles/effect_general.tga"	50
"gem_general_attribute_command_attack_all_situation"	"data/ui/campaign ui/effect_bundles/effect_general.tga"	50
"gem_general_attribute_command_defend_all_situation"	"data/ui/campaign ui/effect_bundles/effect_general.tga"	50
"gem_happiness_building"	"data/ui/campaign ui/effect_bundles/effect_public_order.tga"	9047
"gem_mod_conversion_rate_fujiwara_global"	"data/ui/campaign ui/effect_bundles/gempei_effect_kubota_fujiwara.tga"	3
"gem_mod_conversion_rate_minamoto_global"	"data/ui/campaign ui/effect_bundles/gempei_effect_kamakura_minamoto.tga"	3
"gem_mod_conversion_rate_taira_global"	"data/ui/campaign ui/effect_bundles/gempei_effect_fukuhara_taira.tga"	3
"gem_mod_unit_armour_all"	"data/ui/campaign ui/effect_bundles/effect_armour_buff_positive.tga"	55
"gem_mod_unit_melee_all_local"	"data/ui/campaign ui/effect_bundles/effect_weapon_buff_positive.tga"	54
"gem_mod_unit_recruit_time_bushi"	"data/ui/campaign ui/effect_bundles/effect_army.tga"	2
"gem_mod_unit_recruit_time_naginata"	"data/ui/campaign ui/effect_bundles/effect_army.tga"	2
"gem_mod_unit_xp_warrior_monks"	"data/ui/campaign ui/effect_bundles/effect_army.tga"	3
"gem_research_points_bonus_civil"	"data/ui/campaign ui/effect_bundles/effect_technology.tga"	500
"gem_research_points_bonus_military"	"data/ui/campaign ui/effect_bundles/effect_technology.tga"	500
"gem_tech_admin_cost_mod"	"data/ui/campaign ui/effect_bundles/effect_wealth_positive.tga"	50
"gem_tech_agent_dancer_action_cost_mod"	"data/ui/campaign ui/effect_bundles/effect_subterfuge_positive.tga"	0
"gem_tech_agent_dancer_success"	"data/ui/campaign ui/effect_bundles/effect_ninja_positive.tga"	51
"gem_tech_agent_inspector_action_cost_mod"	"data/ui/campaign ui/effect_bundles/effect_metsuke_positive.tga"	7003
"gem_tech_agent_inspector_success"	"data/ui/campaign ui/effect_bundles/effect_metsuke_positive.tga"	47
"gem_tech_agent_monk_action_cost_mod"	"data/ui/campaign ui/effect_bundles/effect_character_positive.tga"	999
"gem_tech_agent_monk_success"	"data/ui/campaign ui/effect_bundles/effect_monk_positive.tga"	10
"gem_tech_agent_spy_success"	"data/ui/campaign ui/effect_bundles/effect_ninja_positive.tga"	5
"gem_tech_conversion_state_religion"	"data/ui/campaign ui/effect_bundles/effect_religion_positive.tga"	9999
"gem_tech_non_samurai_unit_xp_mod"	"data/ui/campaign ui/effect_bundles/effect_army_positive.tga"	50
"gem_tech_samurai_unit_xp_mod"	"data/ui/campaign ui/effect_bundles/effect_army_positive.tga"	50
"general_ashigaru_bonus"	"data/ui/campaign ui/effect_bundles/effect_ashigaru_units_positive.tga"	999
"general_attribute_command_land_ambush"	"data/ui/campaign ui/effect_bundles/effect_general.tga"	9999
"general_attribute_command_land_amphibious_attack"	"data/ui/campaign ui/effect_bundles/effect_general.tga"	9999
"general_attribute_command_land_attack"	"data/ui/campaign ui/effect_bundles/effect_general.tga"	9999
"general_attribute_command_land_defence"	"data/ui/campaign ui/effect_bundles/effect_general.tga"	9999
"general_attribute_command_land_siege_attack"	"data/ui/campaign ui/effect_bundles/effect_general.tga"	9999
"general_attribute_command_land_siege_defence"	"data/ui/campaign ui/effect_bundles/effect_general.tga"	9999
"general_attribute_command_sea_attack"	"data/ui/campaign ui/effect_bundles/effect_general.tga"	9999
"general_attribute_command_sea_defence"	"data/ui/campaign ui/effect_bundles/effect_general.tga"	9999
"general_aura_mod"	"data/ui/campaign ui/effect_bundles/effect_general.tga"	999
"general_bodyguard_armour_bonus"	"data/ui/campaign ui/effect_bundles/effect_general.tga"	115
"general_bodyguard_attack_bonus"	"data/ui/campaign ui/effect_bundles/effect_general.tga"	999
"general_bodyguard_charge_bonus"	"data/ui/campaign ui/effect_bundles/effect_general.tga"	118
"general_bodyguard_defence_bonus"	"data/ui/campaign ui/effect_bundles/effect_general.tga"	117
"general_bodyguard_morale_bonus"	"data/ui/campaign ui/effect_bundles/effect_general.tga"	116
"general_bodyguard_size_mod"	"data/ui/campaign ui/effect_bundles/effect_general.tga"	999
"general_bow_bonus"	"data/ui/campaign ui/effect_bundles/effect_archer.tga"	999
"general_cavalry_bonus"	"data/ui/campaign ui/effect_bundles/effect_cavalry.tga"	999
"general_honour_bonus"	"data/ui/campaign ui/effect_bundles/effect_general.tga"	222
"general_honourable"	"data/ui/campaign ui/effect_bundles/effect_general.tga"	222
"general_infantry_bonus_mod"	"data/ui/campaign ui/effect_bundles/effect_general.tga"	999
"general_inspire_mod"	"data/ui/campaign ui/effect_bundles/effect_general.tga"	55
"general_loyalty_bonus"	"data/ui/campaign ui/effect_bundles/effect_general.tga"	223
"general_rally_mod"	"data/ui/campaign ui/effect_bundles/effect_general.tga"	565
"general_resistance_bonus"	"data/ui/campaign ui/effect_bundles/effect_public_order.tga"	999
"general_spear_bonus"	"data/ui/campaign ui/effect_bundles/effect_army.tga"	999
"general_swords_bonus"	"data/ui/campaign ui/effect_bundles/effect_army.tga"	999
"gentlemen_happiness_bonus"	"data/ui/campaign ui/effect_bundles/effect_character.tga"	900
"happy_active_upper_gov_type"	"data/ui/campaign ui/effect_bundles/effect_public_order.tga"	9024
"happy_active_upper_tax"	"data/ui/campaign ui/effect_bundles/effect_public_order_negative.tga"	9024
"happy_active_upper_tax_extortionate"	"data/ui/campaign ui/pips/effect_public_order_negative_5.tga"	9024
"happy_active_upper_tax_high"	"data/ui/campaign ui/pips/effect_public_order_negative_4.tga"	9024
"happy_active_upper_tax_low"	"data/ui/campaign ui/pips/effect_public_order_negative_2.tga"	9024
"happy_active_upper_tax_minimal"	"data/ui/campaign ui/pips/effect_public_order_negative_1.tga"	9024
"happy_active_upper_tax_normal"	"data/ui/campaign ui/pips/effect_public_order_negative_3.tga"	9024
"happy_character_lower"	"data/ui/campaign ui/pips/effect_admiral.tga"	9019
"happy_character_upper"	"data/ui/campaign ui/effect_bundles/effect_public_order_positive.tga"	9017
"happy_character_upper_negative"	"data/ui/campaign ui/effect_bundles/effect_public_order_negative.tga"	9017
"happy_culture_all"	"data/ui/campaign ui/effect_bundles/effect_public_order.tga"	9043
"happy_culture_all_global"	"data/ui/campaign ui/effect_bundles/effect_public_order.tga"	9043
"happy_culture_upper"	"data/ui/campaign ui/effect_bundles/effect_public_order.tga"	9011
"happy_culture_upper_global"	"data/ui/campaign ui/effect_bundles/effect_public_order.tga"	9041
"happy_events_global"	"data/ui/campaign ui/effect_bundles/effect_public_order.tga"	9010
"happy_events_local"	"data/ui/campaign ui/effect_bundles/effect_public_order.tga"	9009
"happy_government_upper"	"data/ui/campaign ui/effect_bundles/effect_public_order.tga"	9006
"happy_ministerial_position"	"data/ui/campaign ui/effect_bundles/effect_public_order.tga"	9020
"happy_mod_religious_unrest"	"data/ui/campaign ui/effect_bundles/effect_public_order.tga"	9021
"happy_religion_buddhist"	"data/ui/campaign ui/effect_bundles/effect_public_order_positive.tga"	9029
"happy_religion_buddhist_negative"	"data/ui/campaign ui/effect_bundles/effect_public_order_negative.tga"	9029
"happy_religion_catholic"	"data/ui/campaign ui/effect_bundles/effect_public_order_positive.tga"	9030
"happy_religion_catholic_negative"	"data/ui/campaign ui/effect_bundles/effect_public_order_negative.tga"	9030
"happy_religion_ikko"	"data/ui/campaign ui/effect_bundles/effect_ikko_positive.tga"	9028
"happy_religion_upper"	"data/ui/campaign ui/effect_bundles/effect_public_order.tga"	9038
"happy_resistance_mod_general"	"data/ui/campaign ui/effect_bundles/effect_public_order.tga"	5
"happy_tax_active_upper"	"data/ui/campaign ui/effect_bundles/effect_public_order.tga"	9026
"happy_tax_upper"	"data/ui/campaign ui/effect_bundles/effect_public_order.tga"	9000
"hide_enable_long_grass"	"data/ui/campaign ui/effect_bundles/effect_army.tga"	1
"hide_enable_scrub"	"data/ui/campaign ui/effect_bundles/effect_army.tga"	1
"hide_enable_snipe"	"data/ui/campaign ui/effect_bundles/effect_army.tga"	1
"hide_enable_stalk"	"data/ui/campaign ui/effect_bundles/effect_army.tga"	1
"line_of_sight_mod"	"data/ui/campaign ui/effect_bundles/effect_army.tga"	1
"looting_mod"	"data/ui/campaign ui/effect_bundles/effect_army.tga"	1
"management_army"	"data/ui/campaign ui/effect_bundles/effect_army.tga"	2
"management_finance"	"data/ui/campaign ui/effect_bundles/effect_wealth.tga"	4
"management_justice"	"data/ui/campaign ui/effect_bundles/effect_daimyo.tga"	5
"management_navy"	"data/ui/campaign ui/effect_bundles/effect_navy.tga"	3
"mod_accuracy_artillery"	"data/ui/campaign ui/effect_bundles/effect_army.tga"	1
"mod_accuracy_artillery_all"	"data/ui/campaign ui/effect_bundles/effect_army.tga"	2014
"mod_battle_death_rate"	"data/ui/campaign ui/effect_bundles/effect_army.tga"	1
"mod_boarders_melee_attack"	"data/ui/campaign ui/effect_bundles/effect_navy.tga"	1
"mod_building_construction_cost_castle"	"data/ui/campaign ui/effect_bundles/effect_wealth.tga"	5
"mod_building_repair_cost_castle"	"data/ui/campaign ui/effect_bundles/effect_wealth.tga"	1
"mod_character_loyalty"	"data/ui/campaign ui/effect_bundles/effect_character.tga"	1
"mod_character_loyalty_local"	"data/ui/campaign ui/effect_bundles/effect_character.tga"	999
"mod_character_xp_generals"	"data/ui/campaign ui/effect_bundles/effect_general.tga"	3
"mod_character_xp_metsuke"	"data/ui/campaign ui/effect_bundles/effect_metsuke.tga"	4
"mod_character_xp_monk"	"data/ui/campaign ui/effect_bundles/effect_monk.tga"	4
"mod_character_xp_ninja"	"data/ui/campaign ui/effect_bundles/effect_ninja.tga"	4
"mod_faction_claim"	"data/ui/campaign ui/pips/effect_admiral.tga"	0
"mod_infantry_movement_campaign"	"data/ui/campaign ui/effect_bundles/effect_army.tga"	0
"mod_infantry_training_battle"	"data/ui/campaign ui/effect_bundles/effect_army.tga"	1
"mod_religion_conversion_rate"	"data/ui/campaign ui/effect_bundles/effect_religion.tga"	1
"mod_religion_conversion_rate_buddhist"	"data/ui/campaign ui/effect_bundles/effect_buddhism.tga"	607
"mod_religion_conversion_rate_buddhist_global"	"data/ui/campaign ui/effect_bundles/effect_buddhism.tga"	607
"mod_religion_conversion_rate_christianity"	"data/ui/campaign ui/effect_bundles/effect_christianity.tga"	3
"mod_religion_conversion_rate_christianity_global"	"data/ui/campaign ui/effect_bundles/effect_christianity.tga"	3
"mod_repair_cost_bldg"	"data/ui/campaign ui/effect_bundles/effect_wealth.tga"	1
"mod_ship_attrition"	"data/ui/campaign ui/effect_bundles/effect_navy.tga"	1
"mod_ship_cannon_fire_rate"	"data/ui/campaign ui/effect_bundles/effect_navy.tga"	1
"mod_ship_cannon_reliability"	"data/ui/campaign ui/effect_bundles/effect_navy.tga"	1
"mod_ship_disease_chance"	"data/ui/campaign ui/effect_bundles/effect_navy.tga"	1
"mod_ship_morale_local"	"data/ui/campaign ui/effect_bundles/effect_army.tga"	20
"mod_ship_movement_battle"	"data/ui/campaign ui/effect_bundles/effect_navy.tga"	1
"mod_ship_movement_campaign"	"data/ui/campaign ui/effect_bundles/effect_navy.tga"	1
"mod_storm_damage"	"data/ui/campaign ui/effect_bundles/effect_navy.tga"	1
"mod_tech_cost_all"	"data/ui/campaign ui/effect_bundles/effect_technology.tga"	1
"mod_unit_ability_cooldown"	"data/ui/campaign ui/effect_bundles/effect_army.tga"	5
"mod_unit_ability_uses"	"data/ui/campaign ui/effect_bundles/effect_army.tga"	5
"mod_unit_accuracy_all_local"	"data/ui/campaign ui/effect_bundles/effect_army.tga"	456
"mod_unit_accuracy_bow_samurai_infantry"	"data/ui/campaign ui/effect_bundles/effect_archer.tga"	1
"mod_unit_ap_ships"	"data/ui/campaign ui/effect_bundles/effect_navy.tga"	0
"mod_unit_armour"	"data/ui/campaign ui/effect_bundles/effect_armour_buff_positive.tga"	15
"mod_unit_armour_all_local"	"data/ui/campaign ui/effect_bundles/effect_armour_buff_positive.tga"	16
"mod_unit_armour_ashigaru"	"data/ui/campaign ui/effect_bundles/effect_armour_buff_positive.tga"	5
"mod_unit_armour_samurai"	"data/ui/campaign ui/effect_bundles/effect_armour_buff_positive.tga"	6
"mod_unit_armour_special"	"data/ui/campaign ui/effect_bundles/effect_armour_buff_positive.tga"	7
"mod_unit_charge_all_local"	"data/ui/campaign ui/effect_bundles/effect_army.tga"	17
"mod_unit_charge_bonus_all"	"data/ui/campaign ui/effect_bundles/effect_army.tga"	8
"mod_unit_charge_bonus_cavalry"	"data/ui/campaign ui/effect_bundles/effect_cavalry.tga"	12
"mod_unit_charge_cavalry_local"	"data/ui/campaign ui/effect_bundles/effect_cavalry.tga"	9
"mod_unit_marksmanship"	"data/ui/campaign ui/effect_bundles/effect_army.tga"	6
"mod_unit_melee_all_local"	"data/ui/campaign ui/effect_bundles/effect_weapon_buff_positive.tga"	18
"mod_unit_melee_ashigaru"	"data/ui/campaign ui/effect_bundles/effect_weapon_buff_positive.tga"	2
"mod_unit_melee_attack"	"data/ui/campaign ui/effect_bundles/effect_weapon_buff_positive.tga"	7
"mod_unit_melee_attack_cavalry"	"data/ui/campaign ui/effect_bundles/effect_weapon_buff_positive.tga"	3
"mod_unit_melee_attack_global"	"data/ui/campaign ui/effect_bundles/effect_weapon_buff_positive.tga"	7
"mod_unit_melee_attack_naginata_samurai"	"data/ui/campaign ui/effect_bundles/effect_weapon_buff_positive.tga"	3
"mod_unit_melee_attack_swords"	"data/ui/campaign ui/effect_bundles/effect_weapon_buff_positive.tga"	15
"mod_unit_melee_defence"	"data/ui/campaign ui/effect_bundles/effect_army.tga"	8
"mod_unit_melee_defence_global"	"data/ui/campaign ui/effect_bundles/effect_army.tga"	8
"mod_unit_melee_defence_yari"	"data/ui/campaign ui/effect_bundles/effect_army.tga"	15
"mod_unit_melee_local"	"data/ui/campaign ui/effect_bundles/effect_army.tga"	999
"mod_unit_melee_samurai"	"data/ui/campaign ui/effect_bundles/effect_weapon_buff_positive.tga"	10
"mod_unit_melee_special"	"data/ui/campaign ui/effect_bundles/effect_army.tga"	11
"mod_unit_morale_army"	"data/ui/campaign ui/effect_bundles/effect_army.tga"	912
"mod_unit_morale_cavalry"	"data/ui/campaign ui/effect_bundles/effect_army.tga"	2
"mod_unit_morale_enemy"	"data/ui/campaign ui/effect_bundles/effect_army.tga"	3
"mod_unit_morale_global"	"data/ui/campaign ui/effect_bundles/effect_army.tga"	2
"mod_unit_morale_local"	"data/ui/campaign ui/effect_bundles/effect_army.tga"	12
"mod_unit_morale_navy"	"data/ui/campaign ui/effect_bundles/effect_army.tga"	912
"mod_unit_morale_regional"	"data/ui/campaign ui/effect_bundles/effect_army.tga"	13
"mod_unit_morale_yari_ashigaru"	"data/ui/campaign ui/effect_bundles/effect_ashigaru_units_positive.tga"	2
"mod_unit_recruit_cost_imported_matchlock"	"data/ui/campaign ui/effect_bundles/effect_ranked_fire.tga"	16
"mod_unit_recruit_time_imported_matchlock"	"data/ui/campaign ui/effect_bundles/effect_ranked_fire.tga"	15
"mod_unit_recruitment_cost_all"	"data/ui/campaign ui/effect_bundles/effect_wealth.tga"	5
"mod_unit_recruitment_cost_battlefield_ninja"	"data/ui/campaign ui/effect_bundles/effect_wealth.tga"	2
"mod_unit_recruitment_cost_bow_samurai"	"data/ui/campaign ui/effect_bundles/effect_wealth.tga"	2
"mod_unit_recruitment_cost_cavalry"	"data/ui/campaign ui/effect_bundles/effect_wealth.tga"	2
"mod_unit_recruitment_cost_katana_samurai"	"data/ui/campaign ui/effect_bundles/effect_wealth.tga"	1
"mod_unit_recruitment_cost_land_all"	"data/ui/campaign ui/effect_bundles/effect_wealth.tga"	1
"mod_unit_recruitment_cost_land_all_local"	"data/ui/campaign ui/effect_bundles/effect_wealth.tga"	1
"mod_unit_recruitment_cost_melee_infantry"	"data/ui/campaign ui/effect_bundles/effect_wealth.tga"	3
"mod_unit_recruitment_cost_naginata_samurai"	"data/ui/campaign ui/effect_bundles/effect_wealth.tga"	1
"mod_unit_recruitment_cost_naginata_warrior_monks"	"data/ui/campaign ui/effect_bundles/effect_wealth.tga"	1
"mod_unit_recruitment_cost_nanban_port"	"data/ui/campaign ui/effect_bundles/effect_ranked_fire.tga"	12
"mod_unit_recruitment_cost_ships"	"data/ui/campaign ui/effect_bundles/effect_wealth.tga"	1
"mod_unit_recruitment_cost_ships_local"	"data/ui/campaign ui/effect_bundles/effect_wealth.tga"	4
"mod_unit_recruitment_cost_siege"	"data/ui/campaign ui/effect_bundles/effect_wealth.tga"	3
"mod_unit_recruitment_cost_yari_ashigaru"	"data/ui/campaign ui/effect_bundles/effect_wealth.tga"	2
"mod_unit_reload_rate"	"data/ui/campaign ui/effect_bundles/effect_army.tga"	9
"mod_unit_reload_rate_powder"	"data/ui/campaign ui/effect_bundles/effect_army.tga"	5
"mod_unit_replenishment_all"	"data/ui/campaign ui/effect_bundles/effect_army.tga"	8005
"mod_unit_replenishment_all_local"	"data/ui/campaign ui/effect_bundles/effect_army.tga"	999
"mod_unit_upkeep_all_local"	"data/ui/campaign ui/effect_bundles/effect_wealth.tga"	564
"mod_unit_upkeep_battlefield_ninja"	"data/ui/campaign ui/effect_bundles/effect_wealth.tga"	3
"mod_unit_upkeep_bow_samurai_infantry"	"data/ui/campaign ui/effect_bundles/effect_wealth.tga"	3
"mod_unit_upkeep_cavalry"	"data/ui/campaign ui/effect_bundles/effect_wealth.tga"	1
"mod_unit_upkeep_katana_samurai"	"data/ui/campaign ui/effect_bundles/effect_wealth.tga"	2
"mod_unit_upkeep_naginata_samurai_upkeep"	"data/ui/campaign ui/effect_bundles/effect_wealth.tga"	2
"mod_unit_upkeep_naginata_warrior_monk"	"data/ui/campaign ui/effect_bundles/effect_wealth.tga"	2
"mod_unit_upkeep_ships"	"data/ui/campaign ui/effect_bundles/effect_wealth.tga"	2
"mod_unit_upkeep_siege"	"data/ui/campaign ui/effect_bundles/effect_wealth.tga"	4
"mod_unit_upkeep_yari_ashigaru"	"data/ui/campaign ui/effect_bundles/effect_wealth.tga"	1
"mod_unit_weapon"	"data/ui/campaign ui/effect_bundles/effect_weapon_buff_positive.tga"	19
"mod_unit_xp_artillery"	"data/ui/campaign ui/effect_bundles/effect_army.tga"	10
"mod_unit_xp_ashigaru"	"data/ui/campaign ui/effect_bundles/effect_ashigaru_units_positive.tga"	11
"mod_unit_xp_battlefield_ninja"	"data/ui/campaign ui/effect_bundles/effect_army.tga"	14
"mod_unit_xp_bow_samurai"	"data/ui/campaign ui/effect_bundles/effect_samurai_units.tga"	4
"mod_unit_xp_bow_warrior_monks"	"data/ui/campaign ui/effect_bundles/effect_army.tga"	20
"mod_unit_xp_cavalry"	"data/ui/campaign ui/effect_bundles/effect_army.tga"	10
"mod_unit_xp_katana_samurai"	"data/ui/campaign ui/effect_bundles/effect_samurai_units_positive.tga"	3
"mod_unit_xp_matchlock"	"data/ui/campaign ui/effect_bundles/effect_army.tga"	3
"mod_unit_xp_naginata_samurai"	"data/ui/campaign ui/effect_bundles/effect_army.tga"	4
"mod_unit_xp_naginata_warrior_monks"	"data/ui/campaign ui/effect_bundles/effect_army.tga"	3
"mod_unit_xp_ranged_infantry"	"data/ui/campaign ui/effect_bundles/effect_army.tga"	10
"mod_unit_xp_samurai"	"data/ui/campaign ui/effect_bundles/effect_samurai_units_positive.tga"	10
"mod_unit_xp_ships"	"data/ui/campaign ui/effect_bundles/effect_army.tga"	10
"mod_unit_xp_spearmen"	"data/ui/campaign ui/effect_bundles/effect_army.tga"	3
"mod_unit_xp_swordsmen"	"data/ui/campaign ui/effect_bundles/effect_army.tga"	3
"mod_weapon_misfire"	"data/ui/campaign ui/effect_bundles/effect_firearm_positive.tga"	1
"mod_weapon_misfire_rain"	"data/ui/campaign ui/effect_bundles/effect_firearm_positive.tga"	1
"morale_bonus"	"data/ui/campaign ui/effect_bundles/effect_army.tga"	562
"morale_bonus_land"	"data/ui/campaign ui/effect_bundles/effect_army.tga"	0
"morale_bonus_naval"	"data/ui/campaign ui/effect_bundles/effect_army.tga"	0
"movement_points_all_land_regional"	"data/ui/campaign ui/effect_bundles/effect_army.tga"	1
"movement_points_all_local"	"data/ui/campaign ui/effect_bundles/effect_army.tga"	8050
"movement_points_character"	"data/ui/campaign ui/effect_bundles/effect_character.tga"	999
"movement_points_sea"	"data/ui/campaign ui/effect_bundles/effect_navy.tga"	999
"naval_attrition"	"data/ui/campaign ui/effect_bundles/effect_navy.tga"	0
"naval_recruitment_points"	"data/ui/campaign ui/effect_bundles/effect_navy.tga"	10
"null_effect_christian_building"	"data/ui/campaign ui/effect_bundles/effect_construction.tga"	1
"personal_security"	"data/ui/campaign ui/effect_bundles/effect_character.tga"	4
"placeholder"	"data/ui/campaign ui/pips/effect_admiral.tga"	111
"policing_cost_mod"	"data/ui/campaign ui/pips/effect_admiral.tga"	1
"prestige_region_mod"	"data/ui/campaign ui/effect_bundles/effect_character.tga"	0
"recruitment_cost_mod_category_artillery"	"data/ui/campaign ui/effect_bundles/effect_wealth.tga"	2019
"recruitment_cost_mod_category_artillery_global"	"data/ui/campaign ui/effect_bundles/effect_wealth.tga"	2018
"recruitment_cost_mod_category_cavalry"	"data/ui/campaign ui/effect_bundles/effect_wealth.tga"	2010
"recruitment_cost_mod_category_cavalry_global"	"data/ui/campaign ui/effect_bundles/effect_wealth.tga"	2000
"recruitment_cost_mod_category_infantry"	"data/ui/campaign ui/effect_bundles/effect_wealth.tga"	2012
"recruitment_cost_mod_category_infantry_global"	"data/ui/campaign ui/effect_bundles/effect_wealth.tga"	2011
"recruitment_cost_mod_category_naval_merchant"	"data/ui/campaign ui/effect_bundles/effect_wealth.tga"	2001
"recruitment_cost_mod_category_naval_specialist"	"data/ui/campaign ui/pips/effect_admiral.tga"	2006
"recruitment_cost_mod_land_all"	"data/ui/campaign ui/effect_bundles/effect_wealth.tga"	2031
"recruitment_cost_mod_land_all_global"	"data/ui/campaign ui/effect_bundles/effect_wealth.tga"	2030
"recruitment_cost_mod_local"	"data/ui/campaign ui/effect_bundles/effect_wealth.tga"	999
"recruitment_cost_mod_naval_all"	"data/ui/campaign ui/effect_bundles/effect_wealth.tga"	2021
"recruitment_cost_mod_naval_all_global"	"data/ui/campaign ui/effect_bundles/effect_wealth.tga"	2020
"recruitment_points"	"data/ui/campaign ui/effect_bundles/effect_army.tga"	10
"recruitment_points_bonus"	"data/ui/campaign ui/effect_bundles/effect_army.tga"	10
"recruitment_points_home_region"	"data/ui/campaign ui/effect_bundles/effect_army.tga"	3
"recruitment_points_local"	"data/ui/campaign ui/effect_bundles/effect_army.tga"	999
"region_turns_to_surrender"	"data/ui/campaign ui/effect_bundles/effect_army.tga"	0
"regional_happiness_mod"	"data/ui/campaign ui/effect_bundles/effect_public_order_positive.tga"	999
"regional_line_of_sight_mod_global"	"data/ui/campaign ui/effect_bundles/effect_army.tga"	5
"regional_line_of_sight_mod_local"	"data/ui/campaign ui/effect_bundles/effect_army.tga"	5
"reinforcement_range_mod"	"data/ui/campaign ui/effect_bundles/effect_army.tga"	0
"religion_conversion_no_non_state"	"data/ui/campaign ui/effect_bundles/effect_religion.tga"	3
"repair_cost_modifier"	"data/ui/campaign ui/effect_bundles/effect_wealth.tga"	1
"replenishment_percentage_bonus"	"data/ui/campaign ui/effect_bundles/effect_army.tga"	563
"replenishment_percentage_bonus_global"	"data/ui/campaign ui/effect_bundles/effect_army_positive.tga"	2
"repression_building"	"data/ui/campaign ui/effect_bundles/effect_public_order.tga"	8010
"repression_building_global"	"data/ui/campaign ui/effect_bundles/effect_public_order.tga"	8009
"repression_character"	"data/ui/campaign ui/effect_bundles/effect_public_order.tga"	8009
"repression_events_global"	"data/ui/campaign ui/effect_bundles/effect_public_order.tga"	8009
"repression_events_local"	"data/ui/campaign ui/effect_bundles/effect_public_order.tga"	8009
"repression_garrison"	"data/ui/campaign ui/effect_bundles/effect_public_order.tga"	8008
"repression_gov_type"	"data/ui/campaign ui/effect_bundles/effect_public_order.tga"	8007
"repression_tech_faction"	"data/ui/campaign ui/effect_bundles/effect_public_order.tga"	8005
"repression_tech_homeregion"	"data/ui/campaign ui/pips/effect_admiral.tga"	8004
"requiem_of_the_dead"	"data/ui/campaign ui/effect_bundles/effect_midwinter_positive.tga"	2
"research_points"	"data/ui/campaign ui/effect_bundles/effect_technology.tga"	7005
"research_points_bonus_all"	"data/ui/campaign ui/effect_bundles/effect_technology.tga"	7000
"research_points_bonus_civil"	"data/ui/campaign ui/effect_bundles/effect_technology.tga"	7002
"research_points_bonus_military"	"data/ui/campaign ui/effect_bundles/effect_technology.tga"	7001
"research_points_enlightenment"	"data/ui/campaign ui/effect_bundles/effect_technology.tga"	7003
"research_points_global"	"data/ui/campaign ui/effect_bundles/effect_technology.tga"	7004
"research_rate_mod"	"data/ui/campaign ui/effect_bundles/effect_technology.tga"	7000
"road_level_one"	"data/ui/campaign ui/effect_bundles/effect_army.tga"	456
"road_level_three"	"data/ui/campaign ui/effect_bundles/effect_army.tga"	457
"road_level_two"	"data/ui/campaign ui/effect_bundles/effect_army.tga"	458
"road_level_zero"	"data/ui/campaign ui/effect_bundles/effect_army.tga"	10
"ship_repair_increase"	"data/ui/campaign ui/effect_bundles/effect_navy.tga"	1
"shogun_land_sold_to_portugal"	"data/ui/campaign ui/effect_bundles/effect_wealth.tga"	1
"shogun_land_sold_to_portugal_honour_penalty"	"data/ui/campaign ui/effect_bundles/effect_daimyo_negative.tga"	2
"shogun_null_effect_great_guard"	"data/ui/campaign ui/effect_bundles/effect_cavalry.tga"	1000
"shogun_null_effect_nihon_maru"	"data/ui/campaign ui/effect_bundles/effect_navy.tga"	2000
"short_campaign_research_rate_mod"	"data/ui/campaign ui/effect_bundles/effect_wealth_positive.tga"	0
"siege_attack_time_mod"	"data/ui/campaign ui/effect_bundles/effect_army.tga"	999
"siege_defend_time_mod"	"data/ui/campaign ui/effect_bundles/effect_army.tga"	999
"spotting_distance_mod"	"data/ui/campaign ui/effect_bundles/effect_army.tga"	999
"tax_bonus_building"	"data/ui/campaign ui/effect_bundles/effect_growth.tga"	8003
"tax_bonus_building_global"	"data/ui/campaign ui/effect_bundles/effect_growth.tga"	8002
"tax_bonus_governor"	"data/ui/campaign ui/effect_bundles/effect_growth.tga"	8002
"tax_bonus_minister"	"data/ui/campaign ui/effect_bundles/effect_growth.tga"	8002
"tax_bonus_technology"	"data/ui/campaign ui/effect_bundles/effect_growth.tga"	8004
"tech_agent_action_cost_mod_geisha"	"data/ui/campaign ui/effect_bundles/effect_geisha_positive.tga"	7001
"tech_agent_action_cost_mod_ikko_monk"	"data/ui/campaign ui/effect_bundles/effect_ikko_monk_positive.tga"	7002
"tech_agent_action_cost_mod_metsuke"	"data/ui/campaign ui/effect_bundles/effect_metsuke_positive.tga"	7003
"tech_agent_action_cost_mod_missionary"	"data/ui/campaign ui/effect_bundles/effect_missionary_positive.tga"	7004
"tech_agent_action_cost_mod_monk"	"data/ui/campaign ui/effect_bundles/effect_monk_positive.tga"	7005
"tech_agent_action_cost_mod_ninja"	"data/ui/campaign ui/effect_bundles/effect_ninja_positive.tga"	7006
"tech_agent_all_cost_mod"	"data/ui/campaign ui/effect_bundles/effect_character_positive.tga"	25
"tech_agent_cost_mod_geisha"	"data/ui/campaign ui/effect_bundles/effect_general_positive.tga"	7007
"tech_agent_cost_mod_general"	"data/ui/campaign ui/effect_bundles/effect_geisha_positive.tga"	7008
"tech_agent_cost_mod_ikko_monk"	"data/ui/campaign ui/effect_bundles/effect_ikko_monk_positive.tga"	7009
"tech_agent_cost_mod_metsuke"	"data/ui/campaign ui/effect_bundles/effect_metsuke_positive.tga"	7010
"tech_agent_cost_mod_missionary"	"data/ui/campaign ui/effect_bundles/effect_missionary_positive.tga"	7011
"tech_agent_cost_mod_monk"	"data/ui/campaign ui/effect_bundles/effect_monk_positive.tga"	7012
"tech_agent_cost_mod_ninja"	"data/ui/campaign ui/effect_bundles/effect_ninja_positive.tga"	7013
"tech_agent_ikko_monk_cap_bonus"	"data/ui/campaign ui/effect_bundles/effect_ikko_monk_positive.tga"	48
"tech_agent_ikko_monk_success_mod"	"data/ui/campaign ui/effect_bundles/effect_ikko_monk_positive.tga"	49
"tech_agent_metsuke_cap_bonus"	"data/ui/campaign ui/effect_bundles/effect_metsuke_positive.tga"	46
"tech_agent_metsuke_success_mod"	"data/ui/campaign ui/effect_bundles/effect_metsuke_positive.tga"	47
"tech_agent_missionary_success_mod"	"data/ui/campaign ui/effect_bundles/effect_missionary_positive.tga"	55
"tech_agent_monk_cap_bonus"	"data/ui/campaign ui/effect_bundles/effect_monk_positive.tga"	48
"tech_agent_monk_success_mod"	"data/ui/campaign ui/effect_bundles/effect_monk_positive.tga"	49
"tech_agent_ninja_cap_bonus"	"data/ui/campaign ui/effect_bundles/effect_ninja_positive.tga"	50
"tech_agent_ninja_success_mod"	"data/ui/campaign ui/effect_bundles/effect_ninja_positive.tga"	51
"tech_building_castle_constr_mod"	"data/ui/campaign ui/effect_bundles/effect_construction_positive.tga"	5
"tech_building_castle_cost_mod"	"data/ui/campaign ui/effect_bundles/effect_wealth_positive.tga"	5
"tech_clan_daimyo_honour_mod"	"data/ui/campaign ui/effect_bundles/effect_daimyo_positive.tga"	1
"tech_clan_fame_bonus"	"data/ui/campaign ui/effect_bundles/effect_daimyo_positive.tga"	1
"tech_clan_income_farm_mod"	"data/ui/campaign ui/effect_bundles/effect_wealth_positive.tga"	1
"tech_clan_income_mine_mod"	"data/ui/campaign ui/effect_bundles/effect_wealth_positive.tga"	1
"tech_clan_income_tax_mod"	"data/ui/campaign ui/effect_bundles/effect_wealth_positive.tga"	1
"tech_clan_income_trade_mod"	"data/ui/campaign ui/effect_bundles/effect_wealth_positive.tga"	1
"tech_diplomatic_relations_mod"	"data/ui/campaign ui/effect_bundles/effect_diplomacy_positive.tga"	5
"tech_enable_banzai"	"data/ui/campaign ui/effect_bundles/effect_banzai_positive.tga"	1
"tech_enable_blinding_grenades"	"data/ui/campaign ui/effect_bundles/effect_banzai_positive.tga"	1
"tech_enable_fire_arrows"	"data/ui/campaign ui/effect_bundles/effect_fire_arrows_positive.tga"	1
"tech_enable_pike_square"	"data/ui/campaign ui/effect_bundles/effect_pike_square_positive.tga"	1
"tech_enable_ranked_fire"	"data/ui/campaign ui/effect_bundles/effect_ranked_fire_positive.tga"	1
"tech_enable_stand_and_fight"	"data/ui/campaign ui/effect_bundles/effect_ranked_fire_positive.tga"	715
"tech_enable_swooping_crane"	"data/ui/campaign ui/effect_bundles/effect_swooping_crane_positive.tga"	1
"tech_enable_wedge_formation"	"data/ui/campaign ui/effect_bundles/effect_wedge_formation_positive.tga"	716
"tech_general_aoe_mod"	"data/ui/campaign ui/effect_bundles/effect_general_positive.tga"	99
"tech_general_loyalty_bonus"	"data/ui/campaign ui/effect_bundles/effect_general_positive.tga"	1
"tech_regional_happiness_mod"	"data/ui/campaign ui/effect_bundles/effect_public_order_positive.tga"	1
"tech_regional_repression_mod"	"data/ui/campaign ui/effect_bundles/effect_public_order.tga"	1
"tech_regional_town_wealth_mod"	"data/ui/campaign ui/effect_bundles/effect_wealth_positive.tga"	1
"tech_rel_converserion_buddhist_mod"	"data/ui/campaign ui/effect_bundles/effect_buddhism_positive.tga"	1
"tech_unit_archer_acc_mod"	"data/ui/campaign ui/effect_bundles/effect_archer_positive.tga"	1
"tech_unit_archer_range_mod"	"data/ui/campaign ui/effect_bundles/effect_archer_positive.tga"	1
"tech_unit_archer_reload_mod"	"data/ui/campaign ui/effect_bundles/effect_archer_positive.tga"	1
"tech_unit_archer_xp_mod"	"data/ui/campaign ui/effect_bundles/effect_archer_positive.tga"	1
"tech_unit_horoku_accuacy_mod"	"data/ui/campaign ui/effect_bundles/effect_army_positive.tga"	1
"tech_unit_land_ammo_mod"	"data/ui/campaign ui/effect_bundles/effect_army_positive.tga"	1
"tech_unit_land_charge_bonus_mod"	"data/ui/campaign ui/effect_bundles/effect_army_positive.tga"	1
"tech_unit_land_cost_mod"	"data/ui/campaign ui/effect_bundles/effect_wealth_positive.tga"	1
"tech_unit_land_def_mod"	"data/ui/campaign ui/effect_bundles/effect_army_positive.tga"	1
"tech_unit_land_morale_mod"	"data/ui/campaign ui/effect_bundles/effect_army_positive.tga"	1
"tech_unit_land_movement_mod"	"data/ui/campaign ui/effect_bundles/effect_army_positive.tga"	1
"tech_unit_land_run_speed_mod"	"data/ui/campaign ui/effect_bundles/effect_army_positive.tga"	1
"tech_unit_musket_acc_mod"	"data/ui/campaign ui/effect_bundles/effect_firearm_positive.tga"	1
"tech_unit_naval_battle_movement_mod"	"data/ui/campaign ui/effect_bundles/effect_navy_positive.tga"	1
"tech_unit_naval_cost_mod"	"data/ui/campaign ui/effect_bundles/effect_navy_positive.tga"	1
"tech_unit_naval_movement_mod"	"data/ui/campaign ui/effect_bundles/effect_navy_positive.tga"	1
"tech_unit_naval_turn_mod"	"data/ui/campaign ui/effect_bundles/effect_navy_positive.tga"	1
"tech_unit_replenish_mod"	"data/ui/campaign ui/effect_bundles/effect_army_positive.tga"	1
"tech_unit_spear_xp_bonus"	"data/ui/campaign ui/effect_bundles/effect_army_positive.tga"	1
"tech_unit_sword_xp_bonus"	"data/ui/campaign ui/effect_bundles/effect_army_positive.tga"	1
"tech_unit_upkeep_mod"	"data/ui/campaign ui/effect_bundles/effect_wealth_positive.tga"	1
"trade_income_mod"	"data/ui/campaign ui/effect_bundles/effect_trade_positive.tga"	6001
"trade_income_mod_land"	"data/ui/campaign ui/effect_bundles/effect_trade_positive.tga"	6001
"trade_income_mod_sea"	"data/ui/campaign ui/effect_bundles/effect_trade_positive.tga"	6001
"trade_node_mod"	"data/ui/campaign ui/effect_bundles/effect_trade_positive.tga"	6000
"trade_route_all_mod_growth_rate"	"data/ui/campaign ui/effect_bundles/effect_trade_positive.tga"	6002
"trade_routes_mod_max_land"	"data/ui/campaign ui/effect_bundles/effect_trade_positive.tga"	6001
"trade_routes_mod_max_sea"	"data/ui/campaign ui/effect_bundles/effect_trade_positive.tga"	6000
"tw_growth_education"	"data/ui/campaign ui/effect_bundles/effect_growth.tga"	903
"tw_growth_events_global"	"data/ui/campaign ui/effect_bundles/effect_growth.tga"	900
"tw_growth_events_local"	"data/ui/campaign ui/effect_bundles/effect_growth.tga"	900
"tw_growth_government"	"data/ui/campaign ui/effect_bundles/effect_growth.tga"	901
"tw_growth_home_region"	"data/ui/campaign ui/effect_bundles/effect_wealth.tga"	5
"tw_growth_industry"	"data/ui/campaign ui/effect_bundles/effect_growth.tga"	906
"tw_growth_industry_global"	"data/ui/campaign ui/effect_bundles/effect_growth.tga"	900
"tw_growth_ministers_home_theatre"	"data/ui/campaign ui/effect_bundles/effect_growth.tga"	900
"tw_growth_mod_all"	"data/ui/campaign ui/effect_bundles/effect_growth.tga"	925
"tw_growth_mod_infrastructure"	"data/ui/campaign ui/effect_bundles/effect_growth.tga"	999
"tw_growth_mod_metals"	"data/ui/campaign ui/effect_bundles/effect_growth.tga"	907
"tw_growth_mod_nanban_port"	"data/ui/campaign ui/effect_bundles/effect_growth.tga"	912
"tw_growth_mod_port_trade"	"data/ui/campaign ui/effect_bundles/effect_growth.tga"	926
"tw_growth_mod_textiles"	"data/ui/campaign ui/effect_bundles/effect_growth.tga"	908
"tw_growth_port"	"data/ui/campaign ui/effect_bundles/effect_growth.tga"	904
"tw_growth_port_global"	"data/ui/campaign ui/effect_bundles/effect_growth.tga"	904
"tw_growth_roads"	"data/ui/campaign ui/effect_bundles/effect_growth.tga"	902
"tw_growth_taxes_fixed"	"data/ui/campaign ui/effect_bundles/effect_growth.tga"	1
"tw_growth_taxes_modifier"	"data/ui/campaign ui/effect_bundles/effect_growth.tga"	1
"tw_growth_technologies_fixed"	"data/ui/campaign ui/effect_bundles/effect_growth.tga"	924
"tw_growth_visible_tax_effect_extortionate"	"data/ui/campaign ui/pips/effect_growth_5.tga"	2
"tw_growth_visible_tax_effect_high"	"data/ui/campaign ui/pips/effect_growth_4.tga"	2
"tw_growth_visible_tax_effect_low"	"data/ui/campaign ui/pips/effect_growth_2.tga"	2
"tw_growth_visible_tax_effect_minimal"	"data/ui/campaign ui/pips/effect_growth_1.tga"	2
"tw_growth_visible_tax_effect_normal"	"data/ui/campaign ui/pips/effect_growth_3.tga"	2
"unit_archer_accuracy_mod"	"data/ui/campaign ui/effect_bundles/effect_archer_positive.tga"	999
"unit_archer_reload_mod"	"data/ui/campaign ui/effect_bundles/effect_archer_positive.tga"	999
"unit_mod_all_recruit_time_global"	"data/ui/campaign ui/effect_bundles/effect_army.tga"	17
"unit_mod_samurai_archer_recruit_time"	"data/ui/campaign ui/effect_bundles/effect_samurai_units_positive.tga"	18
"unit_mod_samurai_cavalry_recruit_time"	"data/ui/campaign ui/effect_bundles/effect_samurai_units_positive.tga"	19
"unit_mod_samurai_matchlock_recruit_time"	"data/ui/campaign ui/effect_bundles/effect_samurai_units_positive.tga"	20
"unit_mod_samurai_spear_recruit_time"	"data/ui/campaign ui/effect_bundles/effect_samurai_units_positive.tga"	21
"unit_mod_samurai_sword_recruit_time"	"data/ui/campaign ui/effect_bundles/effect_samurai_units_positive.tga"	22
"upkeep_cost_mod_category_artillery"	"data/ui/campaign ui/effect_bundles/effect_wealth.tga"	3009
"upkeep_cost_mod_category_cavalry"	"data/ui/campaign ui/effect_bundles/effect_wealth.tga"	3010
"upkeep_cost_mod_category_infantry"	"data/ui/campaign ui/effect_bundles/effect_wealth.tga"	3011
"upkeep_cost_mod_category_naval_merchant"	"data/ui/campaign ui/effect_bundles/effect_wealth.tga"	3001
"upkeep_cost_mod_category_naval_specialist"	"data/ui/campaign ui/pips/effect_admiral.tga"	3006
"upkeep_cost_mod_land_all"	"data/ui/campaign ui/effect_bundles/effect_wealth.tga"	3013
"upkeep_cost_mod_naval_all"	"data/ui/campaign ui/effect_bundles/effect_wealth.tga"	3012
