version 1, schema effect_bundles_tables, guid c6311e0b-01ba-447d-8e9f-b1a2f59fd966
unknown1(string)	unknown2(string)	unknown3(string)	unknown4(string)
"bos_aizu"	"A strong tree always has deep roots."	"The Traditionalists"	"bos_effect_faction_aizu.tga"
"bos_choshu"	"Some hatreds have to be nurtured for centuries."	"The Emperor's Fury"	"bos_effect_faction_chosu.tga"
"bos_clan_level_1"	"Keeping tradition alive ensures the power of the old ways."	"Clan Development Level 1"	"bos_effect_clan_level_positive.tga"
"bos_clan_level_2"	"Leaving tradition behind erodes the skills of the past."	"Clan Development Level 2"	"bos_effect_clan_level_positive.tga"
"bos_clan_level_3"	"Adopting modern, foreign ways is right for Japan, but will the people accept them?"	"Clan Development Level 3"	"bos_effect_clan_level_positive.tga"
"bos_clan_level_4"	"A fully modernised clan is the envy of Japan. The population will be made to understand."	"Clan Development Level 4"	"bos_effect_clan_level_positive.tga"
"bos_clan_level_5"	"Modernisation and populations can co-exist in harmony as long as the people are kept in check."	"Clan Development Level 5"	"bos_effect_clan_level_positive.tga"
"bos_clan_level_6"	"A fully modernised clan is the envy of Japan. The population will be made to understand."	"Clan Development Level 6"	"bos_effect_clan_level_positive.tga"
"bos_jozai"	"The unexpected blow is always the hardest to bear."	"The Hidden Warriors"	"bos_effect_faction_jozai.tga"
"bos_minor_clan"	"Minor Clan"	"not_displayed"	"gempei_effect_kiso_minamoto.tga"
"bos_nagaoka"	"Money wins wars; men fight them."	"The Tycoons"	"bos_effect_faction_nagaoka.tga"
"bos_obama"	"All must learn their place."	"The Overseers"	"bos_effect_faction_preorder_obama.tga"
"bos_saga"	"Wisdom has no country."	"The Emperor’s Diligence"	"bos_effect_faction_preorder_saga.tga"
"bos_satsuma"	"Much can be achieved away from the eyes of the great and good."	"The Emperor’s Ambition"	"bos_effect_faction_satsuma.tga"
"bos_sendai"	"Talk quietly, at least until swords are drawn."	"The Negotiators"	"bos_effect_faction_preorder_sendai.tga"
"bos_tosa"	"The sea cannot be conquered, only endured."	"The Emperor’s Reason"	"bos_effect_faction_tosa.tga"
"bos_tsu"	"One road can have many destinations."	"The Emperor’s Cunning"	"bos_effect_faction_preorder_ueno.tga"
"gem_fujiwara_hiraizumi"	"Power lies in the shadows"	"Expedient"	"gempei_effect_hiraizumi_fujiwara.tga"
"gem_fujiwara_kubota"	"Power lies in the ancestors"	"Illustrious"	"gempei_effect_kubota_fujiwara.tga"
"gem_minamoto_kamakura"	"Power lies in the sword"	"Indomitable"	"gempei_effect_kamakura_minamoto.tga"
"gem_minamoto_kiso"	"Power lies in the warrior's way"	"Relentless"	"gempei_effect_kiso_minamoto.tga"
"gem_minor"	"not_displayed"	"not_displayed"	"effect_daimyo.tga"
"gem_taira_fukuhara"	"Power lies in the family"	"Prevailing"	"gempei_effect_fukuhara_taira.tga"
"gem_taira_yashima"	"Power lies in the blood"	"Seaborne"	"gempei_effect_yashima_taira.tga"
"l_first_legendary_archery"	"Your clan was the first in Japan to build this legendary testament to excellence in archery."	"Legendary Kyudo School"	"effect_archer.tga"
"l_first_legendary_buddhist"	"Your clan was the first in Japan to build this legendary testament to the Buddhist way (effects apply only as long as your clan is Buddhist)."	"Famous Temple"	"effect_buddhism.tga"
"l_first_legendary_cavalry"	"Your clan was the first in Japan to build this legendary testament to great horsemanship."	"Legendary Bajutsu School"	"effect_cavalry.tga"
"l_first_legendary_christian"	"Your clan was the first in Japan to build this legendary testament to the Christian way (effects apply only as long as your clan is Christian)."	"Cathedral"	"effect_christianity.tga"
"l_first_legendary_craft"	"Your clan was the first in Japan to build this legendary testament to economic excellence."	"Kabunakama"	"effect_wealth.tga"
"l_first_legendary_siege"	"Your clan was the first in Japan to build this legendary testament to its mastery of siegecraft and gunpowder."	"Arsenal"	"effect_firearm.tga"
"l_first_legendary_stealth"	"Your clan was the first in Japan to build this legendary testament to the clandestine arts."	"Infamous Mizu Shobai District"	"effect_ninja.tga"
"l_first_legendary_sword"	"Your clan was the first in Japan to build this legendary testament to great swordsmanship."	"Legendary Kenjutsu School"	"effect_weapon_buff.tga"
"l_first_legendary_yari"	"Your clan was the first in Japan to build this legendary testament to excellence with the spear."	"Legendary Sojutsu School"	"effect_weapon_buff.tga"
"p_able_sailors"	"As a result of your efforts in naval matters, many able sailors are making themselves available for work aboard your ships."	"Able Sailors"	"effect_navy_positive.tga"
"p_abundant_catch_global"	"Favourable conditions and long hours have ensured that fishermen across your domain have kept their nets brimming."	"Abundant Catch"	"effect_food_positive.tga"
"p_abundant_catch_local"	"Favourable conditions and long hours have ensured that fishermen in this province have kept their nets brimming."	"Abundant Catch"	"effect_food_positive.tga"
"p_administrative_insight"	"By virtue of your recent focus on administration and infrastructure, your clan has made significant progress in civil matters."	"Civil Insight"	"effect_technology_positive.tga"
"p_aggressive_ardour"	"A focus on offensive measures has given your troops a marked advantage in close-combat."	"Aggressive Ardour"	"effect_army_positive.tga"
"p_agrarian_toil_global"	"Efficient exploitation of fertile lands across your realm has led to a significant increase in agricultural wealth."	"Agrarian Toil"	"effect_trade_positive.tga"
"p_agrarian_toil_local"	"Efficient exploitation of the fertile land has increased the agricultural wealth generated from this province."	"Agrarian Toil"	"effect_trade_positive.tga"
"p_ample_supplies"	"An abundant source of military equipment has significantly reduced the cost of equipping new troops for war."	"Ample Supplies"	"effect_weapon_buff_positive.tga"
"p_anti_nanban_riots_global"	"People across your territory are sickened by recent concessions made in favour of the nanban and their ways. "	"Anti-Nanban Riots"	"effect_public_order_negative.tga"
"p_anti_nanban_riots_local"	"People in this province are sickened by recent concessions made in favour of the nanban and their ways. "	"Anti-Nanban Riots"	"effect_public_order_negative.tga"
"p_bos_ample_supplies"	"An abundant source of military supplies have significantly reduced the cost of equipping new troops for war."	"Ample Supplies"	"bos_effect_modern_infantry_melee_positive.tga"
"p_bos_anti_western_riots_global"	"People across your domain are sickened by recent concessions made in favour of westerners."	"Anti-western Riots"	"bos_effect_disaster_negative.tga"
"p_bos_anti_western_riots_local"	"People in this province are sickened by recent concessions made in favour of westerners."	"Anti-western Riots"	"bos_effect_disaster_negative.tga"
"p_bos_autumn"	"A season for change.\\nLeaves playfully mock the wind.\\nAutumn has come."	"Autumn"	"bos_effect_season_autumn.tga"
"p_bos_better_geisha"	"Imbued with confidence and charm, your geisha are capable of lifting even the sternest of souls with their art."	"Irresistible Charmers"	"bos_effect_geisha_positive.tga"
"p_bos_better_ishinshishi"	"Utterly devoted to the Emperor's return to power, your ishin shishi fight with unbridled zeal."	"Imperial Champions"	"bos_effect_ishin_shishi_positive.tga"
"p_bos_better_shinobi"	"Their clandestine skills honed to perfection, your shinobi are excelling in acts of subterfuge."	"Deadly Shadows"	"bos_effect_ninja_positive.tga"
"p_bos_better_shinsengumi"	"Unwavering in their loyalty to the Shogunate, your shinsengumi fervently carry out their duties."	"Defenders of the Shogunate"	"bos_effect_shinsengumi_positive.tga"
"p_bos_better_veteran"	"Their experience unmatched, the foreign veterans in your service provide vital support for the war effort."	"Martial Experts"	"bos_effect_foreign_veteran_positive.tga"
"p_bos_breakthrough_civil_eng"	"Public buildings throughout your domain have benefitted from recent advances in civil engineering."	"Civil Breakthrough"	"bos_effect_modernisation_positive.tga"
"p_bos_breakthrough_industrial_sci"	"Industrial breakthroughs have boosted both your production and economy."	"Industrial Breakthrough"	"bos_effect_modernisation_positive.tga"
"p_bos_breakthrough_medical_sci"	"The recent breakthroughs in medical science have proved greatly beneficial to all."	"Medical Breakthrough"	"bos_effect_commodity_tea_positive.tga"
"p_bos_breakthrough_military_eng"	"Advances in military engineering have improved the  efficiency of your artillery production."	"Military Breakthrough"	"bos_effect_artillery_positive.tga"
"p_bos_brigandry_global"	"An increase in criminal acts has affected production across your domain. Unrest is stirring amongst the populace."	"Brigandry"	"bos_effect_public_order_negative.tga"
"p_bos_brigandry_local"	"An increase in criminal acts has affected production in this province. Unrest is stirring amongst the populace."	"Brigandry"	"bos_effect_public_order_negative.tga"
"p_bos_call_to_arms"	"An increasing number of your subjects are clamouring to join the ranks and take arms against the clan's enemies."	"Call to Arms"	"bos_effect_army_positive.tga"
"p_bos_civil_insight"	"By virtue of your focus on infrastructure and culture, your clan has made significant progress in civil matters."	"Civil Insight"	"bos_effect_modernisation_positive.tga"
"p_bos_criminal_contacts_global"	"Owing to your criminal connections, you are better-able to exploit the wealth-producing establishments within your domain."	"Underworld Contacts"	"bos_effect_subterfuge_positive.tga"
"p_bos_criminal_contacts_local"	"Owing to your criminal connections, you are better-able to exploit the wealth-producing establishments in this province."	"Underworld Contacts"	"bos_effect_subterfuge_positive.tga"
"p_bos_disaffected_populace_global"	"Neglect for the wants and needs of the people across your domain has caused resentment to your rule."	"Disaffected Populace"	"bos_effect_public_order_negative.tga"
"p_bos_disaffected_populace_local"	"Neglect for the wants and needs of the people of this province has caused resentment to your rule."	"Disaffected Populace"	"bos_effect_public_order_negative.tga"
"p_bos_dreaded_force"	"Rumours of your martial superiority have spread, crushing the morale of all those who would face your clan in battle."	"Dreaded Force"	"bos_effect_army_positive.tga"
"p_bos_earthquake"	"A tumultuous earthquake has struck this province! Construction efforts and production have been frustrated as the populace cope with the devastation."	"Earthquake"	"bos_effect_disaster_negative.tga"
"p_bos_emperors_mandate"	"In return for your loyal service, the Emperor has openly declared his support for your clan."	"The Emperor's Mandate"	"bos_effect_imperial_allegiance_positive.tga"
"p_bos_fire"	"Raging fires have spread destruction throughout this province's capital, affecting local production and ruining the livelihoods of many of the people."	"Fire"	"bos_effect_disaster_negative.tga"
"p_bos_flourishing_growth_global"	"Business and public services are flourishing throughout your domain, improving the economy."	"Business Flourishes"	"bos_effect_wealth_positive.tga"
"p_bos_flourishing_growth_local"	"Business and public services are flourishing in this province, improving the economy."	"Business Flourishes"	"bos_effect_wealth_positive.tga"
"p_bos_foreign_boost"	"Your recent decisions regarding westerners have resulted in an increase in foreign trade."	"Foreign Trade Boost"	"bos_effect_trade_positive.tga"
"p_bos_foreign_setback"	"Your recent decisions regarding westerners have caused a decline in foreign trade."	"Foreign Trade Setback"	"bos_effect_trade_negative.tga"
"p_bos_grateful_populace_global"	"Your dedication to the wants and needs of the people throughout your domain has engendered feelings of joy and gratitude."	"Grateful Populace"	"bos_effect_public_order_positive.tga"
"p_bos_grateful_populace_local"	"Your dedication to the wants and needs of the people of this province has engendered feelings of joy and gratitude."	"Grateful Populace"	"bos_effect_public_order_positive.tga"
"p_bos_high_yield"	"The recent focus on improving your primary economy has boosted agricultural and mineral wealth."	"High Yield"	"bos_effect_trade_positive.tga"
"p_bos_imperial_propaganda_local"	"Support for the Emperor and his return to power is spreading throughout this province."	"Imperialist Influence"	"bos_effect_imperial_allegiance_positive.tga"
"p_bos_inspired_endeavours_global"	"Your commitment to the clan's wellbeing has filled the people with fervent pride, inspiring them to make a greater effort in their daily lives."	"Inspired Endeavours"	"bos_effect_public_order_positive.tga"
"p_bos_inspired_endeavours_local"	"Your commitment to this province's wellbeing has filled the people with fervent pride, inspiring them to make a greater effort in their daily lives."	"Inspired Endeavours"	"bos_effect_public_order_positive.tga"
"p_bos_iron_fist_local"	"Your reputation for stringent action in response to offence has instilled fear in the people of this province."	"Iron Fist"	"bos_effect_traditional_infantry_melee_positive.tga"
"p_bos_lord_of_war"	"Driven by your mastery of warfare, your armies march fervently into battle."	"Lord of War"	"bos_effect_army_positive.tga"
"p_bos_martial_wisdom"	"By virtue of your focus on martial matters, your clan has made significant military advances."	"Martial Wisdom"	"bos_effect_army_positive.tga"
"p_bos_master_artillery"	"A focus upon gunnery drill has improved the proficiency of your newly-recruited artillery-crews."	"Gunnery Experts"	"bos_effect_artillery_positive.tga"
"p_bos_master_rifles"	"A focus upon firearms training has improved the competence of your newly-recruited riflemen."	"Keen Marksmen"	"bos_effect_modern_infantry_ranged_positive.tga"
"p_bos_master_shipwrights"	"Quality equipment and industrial expertise have improved your clan's ability to build warships."	"Master Shipwrights"	"bos_effect_navy_positive.tga"
"p_bos_military_mission_american"	"You have allowed America to establish a military mission with your clan."	"American Military Mission"	"bos_effect_america.tga"
"p_bos_military_mission_british"	"You have allowed Britain to establish a military mission with your clan."	"British Military Mission"	"bos_effect_britain.tga"
"p_bos_military_mission_french"	"You have allowed France to establish a military mission with your clan."	"French Military Mission"	"bos_effect_france.tga"
"p_bos_peer_contempt"	"Dubious of your recent decisions, your fellow daimyo are harbouring considerable disrespect towards you."	"Peer Contempt"	"bos_effect_diplomacy_negative.tga"
"p_bos_peer_respect"	"Inspired by your recent decisions, your fellow daimyo have gained considerable respect for you."	"Peer Respect"	"bos_effect_diplomacy_positive.tga"
"p_bos_realm_divide_emperor"	"The Emperor has rallied his bannermen: no quarter will be given to those who support the Shogun. The unification of Japan has begun!"	"The Final Push"	"bos_effect_imperial_allegiance_positive.tga"
"p_bos_realm_divide_self"	"You have decided that neither the Shogun nor the Emperor are worthy of Japan's leadership: the country will be united beneath your own banner!"	"Making a Stand"	"bos_effect_independant_allegiance_positive.tga"
"p_bos_realm_divide_shogun"	"The Shogun has rallied his bannermen; no quarter will be given to those who support the Emperor. The unification of Japan has begun!"	"The Final Push"	"bos_effect_shogunate_allegiance_positive.tga"
"p_bos_ronin_marauders_local"	"Lacking the wise guidance of a daimyo, ronin are running amok in this province. "	"Ronin Marauders"	"bos_effect_disaster_negative.tga"
"p_bos_rule_the_waves"	"Inspired by your mastery of combat at sea, your fleets sail fearlessly into battle."	"Rule the Waves"	"bos_effect_navy_positive.tga"
"p_bos_samurai_discontent"	"Your disregard for the old ways has led to a decline in happiness amongst the samurai within your domain. "	"Samurai Discontent"	"bos_effect_public_order_negative.tga"
"p_bos_samurai_satisfaction"	"Samurai within your domain are satisfied with your adherence to tradition."	"Samurai Satisfaction"	"bos_effect_public_order_positive.tga"
"p_bos_security"	"In order to improve security in this province, policing efforts have been stepped up."	"Security Matters"	"bos_effect_military_positive.tga"
"p_bos_shogunate_propaganda_local"	"Support for the Shogun and his continued rule is spreading throughout this province."	"Shogunate Influence"	"bos_effect_shogunate_allegiance_positive.tga"
"p_bos_shoguns_authority"	"In return for your loyal service, the Shogun has openly declared his support for your clan."	"The Shogun's Authority"	"bos_effect_shogunate_allegiance_positive.tga"
"p_bos_slow_research"	"Your have tempered your clan's developmental efforts to help preserve tradition and prevent the loss of cultural identity."	"Developmental Restraint"	"bos_effect_modernisation_negative.tga"
"p_bos_spring"	"Shivering beauty\\nraises my spirit higher. \\nThe herald of spring."	"Spring"	"bos_effect_season_spring.tga"
"p_bos_summer"	"Heralding summer.\\nThe orange blossom in bloom.\\nBright and beautiful."	"Summer"	"bos_effect_season_summer.tga"
"p_bos_thriving_markets"	"As a result of your recent mercantile endeavours trade is now booming throughout your lands."	"Thriving Markets"	"bos_effect_wealth_positive.tga"
"p_bos_wait"	"Patience is a virtue."	"Await Outcome"	"bos_effect_daimyo_positive.tga"
"p_bos_war_fervour"	"Morale is currently running high. Your recent military undertakings have filled your troops with an unquenchable thirst for battle!"	"War Fervour"	"bos_effect_army_positive.tga"
"p_bos_winter"	"When will spring arrive?\\nIn the grip of cold white death,\\nThe earth is smothered."	"Winter"	"bos_effect_season_winter.tga"
"p_call_to_arms"	"Inspired by your recent military endeavours, scores of devoted clansmen have rushed to join the ranks to take arms against the clan's enemies."	"Call to Arms"	"effect_army_positive.tga"
"p_compassion_buddha_global"	"Buddhism abounds as true believers have spread the Buddha's teachings across your domain."	"Compassion of Buddha"	"effect_buddhism_positive.tga"
"p_compassion_buddha_local"	"Buddhism abounds as true believers have spread the Buddha's teachings throughout this province."	"Compassion of Buddha"	"effect_buddhism_positive.tga"
"p_dis_disease"	"Sickness has spread amongst the people in this province, disrupting local production and development."	"Disease"	"effect_disaster_negative.tga"
"p_dis_drought"	"A lack of rainfall across this province has seriously affected farming, resulting in a shortage of food and other agricultural produce."	"Drought"	"effect_disaster_negative.tga"
"p_dis_earthquake"	"A tumultuous earthquake has struck this province! Construction efforts and production have been frustrated as the populace cope with the devastation."	"Earthquake"	"effect_disaster_negative.tga"
"p_dis_fire"	"Raging fires have spread destruction throughout this province's castle town, affecting local production and ruining the livelihoods of many of the people."	"Fire"	"effect_disaster_negative.tga"
"p_dis_flood"	"Flooding has occurred in this province, affecting agriculture and production across the area."	"Flooding"	"effect_disaster_negative.tga"
"p_dis_severe_winter"	"This province is suffering the effects of a long, severe winter. The heavy snowfall and harsh cold has affected local farming and production."	"Severe Winter"	"effect_disaster_negative.tga"
"p_dis_stormy_seas"	"Turbulent waters and raging storms have wrought havoc for this naval force, resulting in the damage of ships and loss of life."	"Stormy Seas"	"effect_disaster_negative.tga"
"p_dis_tsunami"	"This coastal province has been hit by a tsunami, affecting local port activity and impeding production."	"Tsunami"	"effect_disaster_negative.tga"
"p_dis_typhoon"	"A devastating typhoon has swept across this province, leaving a trail of destruction which has affected local construction efforts and production."	"Typhoon"	"effect_disaster_negative.tga"
"p_dis_volcano"	"This volcano has erupted, smothering nearby provinces with volcanic ash."	"Volcano"	"effect_disaster_negative.tga"
"p_disaffected_populace_global"	"Neglect for the wants and needs of the people across your domain has caused resentment to your rule."	"Disaffected Populace"	"effect_public_order_negative.tga"
"p_disaffected_populace_local"	"Neglect for the wants and needs of the people of this province has caused resentment to your rule."	"Disaffected Populace"	"effect_public_order_negative.tga"
"p_disaster"	"These provinces are suffering the after-effects of the recent natural disaster."	"Natural Disaster"	"effect_disaster_negative.tga"
"p_dreaded_force"	"Word of your martial superiority has spread, crushing the morale of all those who would face your clan in battle."	"Dreaded Force"	"effect_military_positive.tga"
"p_foreign_prosperity"	"Your efforts in favour of trade with foreign powers have led to an increase in imports."	"Foreign Prosperity"	"effect_trade_positive.tga"
"p_gem_administrative_insight"	"By virtue of your recent focus on infrastructure and culture, your clan has made significant progress in civil matters."	"Civil Insight"	"effect_technology_positive.tga"
"p_gem_ardent_support"	"Ever true to your family and cause, people across your realm are impervious to all outside influences."	"Ardent Support"	"effect_generic_event_positive.tga"
"p_gem_await_response"	"Patience is a virtue."	"Await Response"	"effect_buddhism.tga"
"p_gem_brigandry_global"	"An increase in criminal acts has impaired production across your domain. Unrest is stirring amongst the populace."	"Brigandry"	"effect_daimyo.tga"
"p_gem_brigandry_local"	"An increase in criminal acts has impaired production in this province. Unrest is stirring amongst the populace."	"Brigandry"	"effect_daimyo.tga"
"p_gem_fujiwara_influence_other"	"Despite our best efforts, knowledge of the Fujiwara's past continues to foster support for them."	"Fujiwara Influence"	"effect_daimyo.tga"
"p_gem_fujiwara_influence_self"	"Word of the family's past achievements has spread; support for the Fujiwara cause is stronger than ever."	"Fujiwara Influence"	"effect_daimyo.tga"
"p_gem_martial_wisdom"	"By virtue of your recent focus on martial matters, your clan has made significant progress in the field of military advancement."	"Martial Wisdom"	"effect_technology_positive.tga"
"p_gem_master_dancer"	"Imbued with confidence and charm, your shirabyoshi are capable of lifting even the sternest of souls."	"Entrancing Allure"	"gempei_effect_dancer_positive.tga"
"p_gem_master_inspector"	"Quick of tongue and cunning to the last, your junsatsushi are championing your cause with irrepressible conviction."	"Influential Exponent"	"effect_metsuke_positive.tga"
"p_gem_master_monk"	"Inspired by their pursuit of enlightenment, your sou are fulfilling their duties with unbounded zeal."	"Noble Truth"	"effect_monk_positive.tga"
"p_gem_master_spy"	"Their skills honed to perfection, your monomi are excelling in acts of subterfuge."	"Clandestine Practices"	"effect_ninja_positive.tga"
"p_gem_minamoto_influence_other"	"Despite our best efforts, knowledge of the Minamoto's past continues to foster support for them."	"Minamoto Influence"	"effect_daimyo.tga"
"p_gem_minamoto_influence_self"	"Word of the family's past achievements has spread; support for the Minamoto cause is stronger than ever."	"Minamoto Influence"	"effect_daimyo.tga"
"p_gem_propaganda"	"Your family’s influence is spreading like wildfire as word of your exploits reaches every corner of the realm."	"Propaganda"	"effect_generic_event_positive.tga"
"p_gem_taira_antoku_enthroned"	"A Taira now sits upon the Chrysanthemum Throne. Your family profits from its newfound position of power, and much of Japan resents that."	"Emperor Antoku"	"effect_daimyo.tga"
"p_gem_taira_influence_other"	"Despite our best efforts, knowledge of the Taira's past continues to foster support for them."	"Taira Influence"	"effect_daimyo.tga"
"p_gem_taira_influence_self"	"Word of the family's past achievements has spread; support for the Taira cause is stronger than ever."	"Taira Influence"	"effect_daimyo.tga"
"p_gem_tax_supplement"	"Your recent initiatives have increased the tax revenue gathered in this province."	"Tax Supplement"	"effect_daimyo.tga"
"p_gem_unwanted_influence_fujiwara"	"Harbouring those with Minamoto and Taira sympathies has allowed their influence to spread throughout your domain."	"Unwanted Influence"	"effect_daimyo.tga"
"p_gem_unwanted_influence_minamoto"	"Harbouring those with Taira and Fujiwara sympathies has allowed their influence to spread throughout your domain."	"Unwanted Influence"	"effect_daimyo.tga"
"p_gem_unwanted_influence_taira"	"Harbouring those with Minamoto and Fujiwara sympathies has allowed their influence to spread throughout your domain."	"Unwanted Influence"	"effect_daimyo.tga"
"p_grateful_populace_global"	"Your dedication to the wants and needs of the people throughout your domain has engendered feelings of joy and gratitude."	"Grateful Populace"	"effect_public_order_positive.tga"
"p_grateful_populace_local"	"Your dedication to the wants and needs of the people of this province has engendered feelings of joy and gratitude."	"Grateful Populace"	"effect_public_order_positive.tga"
"p_inspired_endeavours_global"	"Your commitment to the clan's wellbeing has filled the people with fervent pride, inspiring them to make a greater effort in their daily lives."	"Inspired Endeavours"	"effect_wealth_positive.tga"
"p_inspired_endeavours_local"	"Your commitment to this province's wellbeing has filled the people with fervent pride, inspiring them to make a greater effort in their daily lives."	"Inspired Endeavours"	"effect_wealth_positive.tga"
"p_iron_fist"	"Your reputation for stringent action in response to offence has instilled fear in the people throughout your domain, cowing them into obedience."	"Iron Fist"	"effect_public_order_positive.tga"
"p_lackluster_efforts_global"	"Unmotivated and undisciplined, people across your domain have lost their commitment to the natural order of work and duty."	"Lackluster Efforts"	"effect_public_order_negative.tga"
"p_lackluster_efforts_local"	"Unmotivated and undisciplined, people in this province have lost their commitment to the natural order of work and duty."	"Lackluster Efforts"	"effect_public_order_negative.tga"
"p_lucrative_shipping"	"Your dominance of the shipping lanes has led to an increase of the sea trade conducted through your ports."	"Lucrative Shipping"	"effect_trade_positive.tga"
"p_martial_wisdom"	"By virtue of your recent focus on martial matters, your clan has made significant progress in the field of military advancement."	"Martial Wisdom"	"effect_technology_positive.tga"
"p_master_archers"	"Your devotion to kyujutsu has markedly improved the abilities of your newly-recruited bowmen."	"Keen Marksmen"	"effect_archer_positive.tga"
"p_master_ashigaru"	"Improved ashigaru training methods have improved the combat potential of your ashigaru recruits."	"Superior Ashigaru"	"effect_ashigaru_units_positive.tga"
"p_master_builders"	"Acquisition and use of the best available materials has greatly increased the efficiency of the construction process."	"Master Builders"	"effect_construction_positive.tga"
"p_master_cavalry"	"Your devotion to bajutsu has enabled the training of exceptionally able cavalry recruits."	"Expert Horsemanship"	"effect_cavalry_positive.tga"
"p_master_gunners"	"Improved training with firearms has made your newly-recruited gunmen more proficient in battle."	"Crack Gunmen"	"effect_firearm_positive.tga"
"p_master_horsebreeders"	"Countless hours spent breaking in the finest stock have greatly increased the efficiency of your horse breeders."	"Master Horse Breeders"	"effect_cavalry_positive.tga"
"p_master_ikko_monks"	"Resolute in their Jodo Shinshu convictions, your Ikko monks are fulfilling their spiritual calling with unbounded zeal."	"The True Pure Land"	"effect_ikko_monk_positive.tga"
"p_master_metsuke"	"Driven by their innate sense of justice, your metsuke are carrying out their duties with all the cunning that they can muster."	"Unscrupulous Aegis"	"effect_metsuke_positive.tga"
"p_master_missionaries"	"Empowered by their faith in the almighty, your missionaries are fulfilling their divine mission with unbridled zeal."	"Divine Right"	"effect_missionary_positive.tga"
"p_master_monks"	"Inspired by their pursuit of enlightenment, your monks are fulfilling their duties with unbounded zeal."	"Noble Truth"	"effect_monk_positive.tga"
"p_master_ninja"	"Their skills honed to perfection, your ninja are excelling in acts of subterfuge."	"Clandestine Practices"	"effect_ninja_positive.tga"
"p_master_samurai"	"Improved samurai training methods have given your recruits an edge in combat."	"Exceptional Samurai"	"effect_samurai_units_positive.tga"
"p_master_shipwrights"	"Acquistion and use of the best timber available has greatly increased the efficiency of your shipwrights."	"Master Shipwrights"	"effect_navy_positive.tga"
"p_master_siegecraft"	"A focus upon siegecraft techniques has improved the proficiency of your newly-recruited siege-crews."	"Siegecraft Experts"	"effect_firearm_positive.tga"
"p_master_smithies"	"Countless hours spent at the forge crafting arms and armour from the finest metals have greatly increased the efficiency of your blacksmiths."	"Master Smithies"	"effect_armour_buff_positive.tga"
"p_master_spearmen"	"Your devotion to sojutsu has improved the skill and resolve of your newly-recruited spearmen."	"Inexorable Spearmen"	"effect_weapon_buff_positive.tga"
"p_master_swordsmen"	"Your devotion to kenjutsu has sharpened the skills of your newly-recruited swordsmen."	"Celebrated Swordsmanship"	"effect_weapon_buff_positive.tga"
"p_meagre_harvest"	"A poor crop has severely affected food production throughout your domain."	"Meagre Harvest"	"effect_food_negative.tga"
"p_meagre_harvest_local"	"A poor crop has severely affected food production in this province."	"Meagre Harvest"	"effect_food_negative.tga"
"p_merchant_discontent"	"Trade revenue is in decline as merchants, incensed by your recent dismissal of trade requests, are seeking their livelihoods elsewhere."	"Merchant Class Discontent"	"effect_trade_negative.tga"
"p_nanban_ambassador"	"In return for your favourable attitude towards the nanban, they have dispatched an emissary to help facilitate trade between you."	"Nanban Ambassador"	"effect_diplomacy_positive.tga"
"p_nanban_ire"	"Angered by recent affronts made against them, the nanban have demanded larger payments for their trade goods."	"Nanban Ire"	"effect_diplomacy_negative.tga"
"p_old_ways"	"Your people have been inspired by the knowledge that their daimyo still favours the customs upon which your clan was established. "	"The Old Ways"	"effect_public_order_positive.tga"
"p_peer_contempt"	"Dubious of your recent decisions, your fellow daimyo are harbouring considerable disrespect towards you."	"Peer Contempt"	"effect_diplomacy_negative.tga"
"p_plenty"	"A healthy crop has ensured that there is ample sustenance for your clan."	"Plenty"	"effect_food_positive.tga"
"p_prosperity_global"	"Owing to your regard for its economic wellbeing, your realm is currently experiencing a surge in economic growth."	"Prosperity"	"effect_wealth_positive.tga"
"p_prosperity_local"	"Owing to your regard for its economic wellbeing, this province is currently experiencing a surge in economic growth."	"Prosperity"	"effect_wealth_positive.tga"
"p_provincial_turmoil_global"	"Low morale and a lack of support for your rule have caused widespread dereliction of work and duty amongst the people of your clan."	"Provincial Turmoil"	"effect_wealth_negative.tga"
"p_provincial_turmoil_local"	"Low morale and a lack of support for your rule have caused widespread dereliction of work and duty amongst the people of this province."	"Provincial Turmoil"	"effect_wealth_negative.tga"
"p_rampant_piracy"	"In the wake of your disregard for recent wako threats, pirates are now sweeping across your seas."	"Rampant Piracy"	"effect_trade_negative.tga"
"p_religious_zeal"	"Resolute in their religious convictions, the will of your people has not wavered in the face of spiritual adversity."	"Religious Zeal"	"effect_religion_positive.tga"
"p_research"	"A dedicated approach to mastery of the arts has resulted in significant progress for your clan in both military and civic disciplines."	"Significant Advances"	"effect_technology_positive.tga"
"p_ronin_marauders"	"Their exploits unchecked, ronin have run amok in this province leaving terror and devastation in their wake."	"Ronin Marauders"	"effect_public_order_negative.tga"
"p_rule_the_waves"	"Inspired by your clan's mastery of the sea, your fleets row fearlessly into battle."	"Rule the Waves"	"effect_navy_positive.tga"
"p_shogunal_deputy"	"Satisfied with your recent show of support for his cause, the Shogun has dispatched an official to your capital to aid in matters of state."	"Shogunal Deputy"	"effect_diplomacy_positive.tga"
"p_staunch_defence"	"Owing to an increased focus on clan defence, your troops are better able to withstand melee attacks."	"Staunch Defence"	"effect_armour_buff_positive.tga"
"p_taskmaster_global"	"Your command to intensify construction efforts across your domain has caused them to progress rapidly."	"Taskmaster"	"effect_construction_positive.tga"
"p_taskmaster_local"	"Your command to intensify construction efforts in this province has caused them to progress rapidly."	"Taskmaster"	"effect_construction_positive.tga"
"p_thriving_markets"	"As a result of your recent mercantile endeavours trade is now booming throughout your lands."	"Thriving Markets"	"effect_trade_positive.tga"
"p_vigilance_global"	"Mindful of the clan's defensive needs, clansmen throughout your domain have been keeping a close guard on all comings and goings."	"Vigilance"	"effect_army_positive.tga"
"p_vigilance_local"	"Mindful of the clan's defensive needs, clansmen throughout this province have been keeping a close guard on all comings and goings."	"Vigilance"	"effect_army_positive.tga"
"p_war_fervour"	"Morale is currently running high. Your recent military undertakings have filled your troops with an unquenchable thirst for battle!"	"War Fervour"	"effect_army_positive.tga"
"p_way_words"	"Your politeness and tact has given you an edge in matters of diplomatic relations."	"Way with Words"	"effect_diplomacy_positive.tga"
"p_wisdom_shinran_global"	"Faith in the Ikko cause is strong as people across your lands find solace in Shinran's wise teachings."	"Wisdom of Shinran"	"effect_ikko_positive.tga"
"p_wisdom_shinran_local"	"Faith in the Ikko cause is strong as people in this province find solace in Shinran's wise teachings."	"Wisdom of Shinran"	"effect_ikko_positive.tga"
"p_word_of_god_global"	"Christianity has flourished throughout your lands as converts spread the word of God without fear of repression."	"Word of God"	"effect_christianity_positive.tga"
"p_word_of_god_local"	"Christianity has flourished throughout this province as converts spread the word of God without fear of repression."	"Word of God"	"effect_christianity_positive.tga"
"requiem_of_the_dead"	"Your courage throughout the long, dark winter has not gone unnoticed; Amaterasu blesses you with her light, dispelling fear and doubt amongst your people. (Applies only during the winter season.)"	"Reflection of Amaterasu"	"effect_midwinter_positive.tga"
"s_broken_trade"	"An end to trade with another clan has affected your clan's domestic growth, as merchants adapt to the situation."	"Broken Trade Agreement"	"effect_trade_negative.tga"
"s_christian"	"You have embraced the Christian faith, thereby improving trade relations with the nanban and enabling the construction of Christian buildings."	"Christian"	"effect_christianity_positive.tga"
"s_family_death_mourn"	"Your clan is in mourning following the recent tragic loss of the daimyo and his family."	"In Mourning"	"effect_daimyo_negative.tga"
"s_shogun_effects"	"You are the shogun. All Japan bows before your military might!"	"Shogun"	"effect_daimyo.tga"
"summer_son"	"Amaterasu recognises the victories you have achieved in her honour and accords your warriors her blessing. (Applies only during the summer season.)"	"Blessing of Amaterasu"	"effect_summer_son_positive.tga"
"t_chosokabe"	"As the arrow flies, so travels the honest man."	"Masters of the Land"	"effect_chosokabe.tga"
"t_date"	"The sword that strikes first, strikes hardest."	"Masters of Battle"	"effect_date.tga"
"t_hattori"	"Death comes in many ways, not only in battle."	"Masters of Darkness"	"effect_hattori.tga"
"t_hojo"	"Those who know how to build also know how to destroy."	"Master Builders"	"effect_hojo.tga"
"t_ikko"	"Conquering the soul secures the land."	"Masters of Faith"	"effect_ikko_ikki.tga"
"t_mori"	"Water is stronger than any stone, any steel, any man."	"Masters of the Waves"	"effect_mori.tga"
"t_oda"	"Any man can bravely carry a spear."	"Masters of Peasantry"	"effect_oda.tga"
"t_otomo"	"Shooting an enemy is not a matter of honour, but victory."	"Master Gunners"	"effect_otomo.tga"
"t_shimazu"	"Blood is thicker than water."	"Masters of Integrity"	"effect_shimazu.tga"
"t_takeda"	"Born to the saddle; born to command."	"Masters of Horses"	"effect_takeda.tga"
"t_tokugawa"	"Words are weapons in the mouths of the wise."	"Masters of Intrigue"	"effect_tokugawa.tga"
"t_uesugi"	"Evil will never prevail against those with faith."	"Masters of Prayer"	"effect_uesugi.tga"
