version 1, schema trait_info_tables
Trait_IDRef(string)	Game_Entity(string)
"C_Tribal_Leader_Cursed_Iroquois_Flying_Head"	"agent"
"C_Tribal_Leader_Debauched"	"agent"
"C_Tribal_Leader_Dullard"	"agent"
"C_Tribal_Leader_Foreign_Tastes"	"agent"
"C_Tribal_Leader_Harsh_Ruler"	"agent"
"C_Tribal_Leader_Hindu"	"agent"
"C_Tribal_Leader_Huntin_Shootin_Fishin"	"agent"
"C_Tribal_Leader_Islamic"	"agent"
"C_Tribal_Leader_Mad"	"agent"
"C_Tribal_Leader_Orthodox"	"agent"
"C_Tribal_Leader_Peacemaker"	"agent"
"C_Tribal_Leader_Plains_Cursed"	"agent"
"C_Tribal_Leader_Protestant"	"agent"
"C_Tribal_Minister_Agriculturalist"	"agent"
"C_Tribal_Minister_Army_Good"	"agent"
"C_Tribal_Minister_Industrialist"	"agent"
"C_Tribal_Minister_Trader"	"agent"
"C_Tribal_Scout_Good_Army_Sabotage"	"agent"
"C_Tribal_Scout_Good_Assassin"	"agent"
"C_Tribal_Scout_Good_Spy"	"agent"
"C_Tribal_Scout_Sabot_Good"	"agent"
"C_Tribal_Shaman_Likes_Mushrooms"	"agent"
"C_Tribal_Shaman_Plains_Buffalo_Dancer"	"agent"
"C_Tribal_Shaman_Powwow"	"agent"
"C_Tribal_Shaman_Pueblo_Sun_Dancer"	"agent"
"C_Tribal_Shaman_Research_Military"	"agent"
"C_Admiral_Attacker_Bad"	"agent"
"C_Admiral_Attacker_Good"	"agent"
"C_Admiral_Bad"	"agent"
"C_Admiral_Blockade_Runner_Good"	"agent"
"C_Admiral_Blockader_Good"	"agent"
"C_Admiral_Boring_Speaker"	"agent"
"C_Admiral_Born_Sailor"	"agent"
"C_Admiral_Brave"	"agent"
"C_Admiral_British_Drakes_Drum"	"agent"
"C_Admiral_Coward"	"agent"
"C_Admiral_Cruisers"	"agent"
"C_Admiral_Defender_Bad"	"agent"
"C_Admiral_Defender_Good"	"agent"
"C_Admiral_Drunkard"	"agent"
"C_Admiral_Dutch_Seamanship"	"agent"
"C_Admiral_Good"	"agent"
"C_Admiral_Lampooned"	"agent"
"C_Admiral_Mad"	"agent"
"C_Admiral_Martinet"	"agent"
"C_Admiral_Mathematician"	"agent"
"C_Admiral_Press_Hero"	"agent"
"C_Admiral_Rated_Ships"	"agent"
"C_Admiral_Slacker"	"agent"
"C_Admiral_Sobriety"	"agent"
"C_Admiral_Spanish_National_Pride"	"agent"
"C_Admiral_Swashbuckling"	"agent"
"C_Agent_Secret_Police"	"agent"
"C_Agent_Spy_Network"	"agent"
"C_Feck_Vice"	"agent"
"C_General_Ambush_Good"	"agent"
"C_General_Ambusher_Bad"	"agent"
"C_General_Americas_Bad"	"agent"
"C_General_Americas_Good"	"agent"
"C_General_Attacker_Bad"	"agent"
"C_General_Attacker_Good"	"agent"
"C_General_Austrian_Hates_Ottomans"	"agent"
"C_General_Bad_Field_Commander"	"agent"
"C_General_Bloody"	"agent"
"C_General_Born_Soldier"	"agent"
"C_General_Brave"	"agent"
"C_General_Coward"	"agent"
"C_General_Defender_Bad"	"agent"
"C_General_Defender_Good"	"agent"
"C_General_Drunkard"	"agent"
"C_General_French_Elan"	"agent"
"C_General_Good_Field_Commander"	"agent"
"C_General_India_Bad"	"agent"
"C_General_India_Good"	"agent"
"C_General_Lampooned"	"agent"
"C_General_Mad"	"agent"
"C_General_Marine_Bad"	"agent"
"C_General_Marine_Good"	"agent"
"C_General_Martinet"	"agent"
"C_General_Mughal_Anti_European"	"agent"
"C_General_of_Artillery"	"agent"
"C_General_of_Cavalry"	"agent"
"C_General_of_Infantry"	"agent"
"C_General_Polish_Stubborn"	"agent"
"C_General_Press_Hero"	"agent"
"C_General_Prussian_Blue"	"agent"
"C_General_Russian_Vodka"	"agent"
"C_General_Scout"	"agent"
"C_General_Siege_Attack_Bad"	"agent"
"C_General_Siege_Attack_Good"	"agent"
"C_General_Siege_Defend_Bad"	"agent"
"C_General_Siege_Defend_Good"	"agent"
"C_General_Slacker"	"agent"
"C_General_Swedish_Aggression"	"agent"
"C_General_Turkish_Master_Gunner"	"agent"
"C_General_US_Backwoodsman"	"agent"
"C_General_Warlord"	"agent"
"C_Gent_Academic_Honours"	"agent"
"C_Gent_Duelling_Pistol"	"agent"
"C_Gent_Duelling_Sword"	"agent"
"C_Gent_Research_Agriculture"	"agent"
"C_Gent_Research_Economics"	"agent"
"C_Gent_Research_Industry"	"agent"
"C_Gent_Research_Military"	"agent"
"C_Gent_Research_Navy"	"agent"
"C_Gent_Research_Philosophy"	"agent"
"C_Gent_Science_Club"	"agent"
"C_Honourable_Service"	"agent"
"C_Infected_Cholera"	"agent"
"C_Infected_Dengue_Fever"	"agent"
"C_Infected_Dysentry"	"agent"
"C_Infected_Influenza"	"agent"
"C_Infected_Leprosy"	"agent"
"C_Infected_Malaria"	"agent"
"C_Infected_Measles"	"agent"
"C_Infected_Plague"	"agent"
"C_Infected_Scurvy"	"agent"
"C_Infected_Smallpox"	"agent"
"C_Infected_TB"	"agent"
"C_Infected_Typhus"	"agent"
"C_Infected_Yellow_Fever"	"agent"
"C_Leader_Agent_99"	"agent"
"C_Leader_Army_Buff"	"agent"
"C_Leader_Clever_Stick"	"agent"
"C_Leader_Debauched"	"agent"
"C_Leader_Dullard"	"agent"
"C_Leader_Enlightened_Despot"	"agent"
"C_Leader_Favourites"	"agent"
"C_Leader_Fertile"	"agent"
"C_Leader_Foreign_Tastes"	"agent"
"C_Leader_Harsh_Ruler"	"agent"
"C_Leader_Humanist"	"agent"
"C_Leader_Huntin_Shootin_Fishin"	"agent"
"C_Leader_Inbred"	"agent"
"C_Leader_Infertile"	"agent"
"C_Leader_Intellectual_Pretensions"	"agent"
"C_Leader_M"	"agent"
"C_Leader_Mad"	"agent"
"C_Leader_Merit"	"agent"
"C_Leader_Mr_Waverley"	"agent"
"C_Leader_Natural_King"	"agent"
"C_Leader_Natural_President"	"agent"
"C_Leader_Navy_Buff"	"agent"
"C_Leader_Philistine"	"agent"
"C_Leader_Uncouth"	"agent"
"C_Leader_Witty"	"agent"
"C_Minister_Army_Good"	"agent"
"C_Minister_Corrupt"	"agent"
"C_Minister_Entertainer"	"agent"
"C_Minister_Fiscal_Genius"	"agent"
"C_Minister_Industrialist"	"agent"
"C_Minister_Miser"	"agent"
"C_Minister_Navy_Good"	"agent"
"C_Minister_Physiocrat"	"agent"
"C_Minister_Radical"	"agent"
"C_Minister_Reactionary"	"agent"
"C_Minister_Trader"	"agent"
"C_Minister_Unjust"	"agent"
"C_Minister_Upright"	"agent"
"C_Missionary_Gone_Native"	"agent"
"C_Missionary_Hate_America"	"agent"
"C_Missionary_Hate_Europe"	"agent"
"C_Missionary_Hate_India"	"agent"
"C_Missionary_Like_America"	"agent"
"C_Missionary_Like_Europe"	"agent"
"C_Missionary_Like_India"	"agent"
"C_Missionary_Touched_By_God"	"agent"
"C_Personal_Hale"	"agent"
"C_Personal_High_Personal_Security"	"agent"
"C_Personal_Piety"	"agent"
"C_Personal_Sickly"	"agent"
"C_Rake_Assassin_Good"	"agent"
"C_Rake_Born_Bounder"	"agent"
"C_Rake_Counter_Spy"	"agent"
"C_Rake_Gate_Opener"	"agent"
"C_Rake_Im_A_Laydee"	"agent"
"C_Rake_Naughty_Club"	"agent"
"C_Rake_Sabot_Good"	"agent"
"C_Rake_Spy_Good"	"agent"
"C_Sausage_Vice"	"agent"
"C_Siege_Engineering"	"agent"
"R_Infected_Cholera"	"region"
"R_Infected_Dengue_Fever"	"region"
"R_Infected_Influenza"	"region"
"R_Infected_Leprosy"	"agent"
"R_Infected_Malaria"	"region"
"R_Infected_Measles"	"region"
"R_Infected_Plague"	"region"
"R_Infected_Smallpox"	"region"
"R_Infected_TB"	"region"
"R_Infected_Typhus"	"region"
"R_Infected_Yellow_Fever"	"region"
"U_Acclimatised_Americas"	"unit"
"U_Acclimatised_Europe"	"unit"
"U_Acclimatised_India"	"unit"
"U_Acclimatised_Middle_East"	"unit"
"U_American_Expert_Troops"	"unit"
"U_Bright_Sabres"	"unit"
"U_Cold_Steel"	"unit"
"U_European_Expert_Troops"	"unit"
"U_Indian_Expert_Troops"	"unit"
"U_Infected_Cholera"	"unit"
"U_Infected_Dengue_Fever"	"unit"
"U_Infected_Dysentry"	"unit"
"U_Infected_Influenza"	"unit"
"U_Infected_Malaria"	"unit"
"U_Infected_Measles"	"unit"
"U_Infected_Plague"	"unit"
"U_Infected_Scurvy"	"unit"
"U_Infected_Smallpox"	"unit"
"U_Infected_TB"	"unit"
"U_Infected_Typhus"	"unit"
"U_Infected_Yellow_Fever"	"unit"
"U_Magic_Talismans"	"unit"
"U_Prime_Mover"	"unit"
"U_Repressive_Policing"	"unit"
"U_Sharpshooters"	"unit"
"U_Ship_Boarding_Attack"	"unit"
"U_Ship_Boarding_Defence"	"unit"
"C_Tribal_General_Attacker_Bad"	"agent"
"C_Tribal_General_Attacker_Good"	"agent"
"C_Tribal_General_Bad_Field_Commander"	"agent"
"C_Tribal_General_Bloody"	"agent"
"C_Tribal_General_Born_Soldier"	"agent"
"C_Tribal_General_Brave"	"agent"
"C_Tribal_General_Cherokee"	"agent"
"C_Tribal_General_Coward"	"agent"
"C_Tribal_General_Defender_Bad"	"agent"
"C_Tribal_General_Defender_Good"	"agent"
"C_Tribal_General_Good_Field_Commander"	"agent"
"C_Tribal_General_Hates_Europeans"	"agent"
"C_Tribal_General_Hates_Europeans_Reset"	"agent"
"C_Tribal_General_Huron"	"agent"
"C_Tribal_General_Iroquois"	"agent"
"C_Tribal_General_Lampooned"	"agent"
"C_Tribal_General_Mad"	"agent"
"C_Tribal_General_of_Cavalry"	"agent"
"C_Tribal_General_Plains"	"agent"
"C_Tribal_General_Plains_Coup"	"agent"
"C_Tribal_General_Press_Hero"	"agent"
"C_Tribal_General_Pueblo"	"agent"
"C_Tribal_General_Siege_Attack_Bad"	"agent"
"C_Tribal_General_Siege_Attack_Good"	"agent"
"C_Tribal_General_Siege_Defend_Bad"	"agent"
"C_Tribal_General_Siege_Defend_Good"	"agent"
"C_Tribal_Leader_Catholic"	"agent"
"C_Tribal_Leader_Clever_Stick"	"agent"
