version 1, schema quotes_tables
Text(string)	Author(string)	Quote_ID(string)
"Sir, I had little hopes on Monday last but to have supped in your cabin: but it pleased God to order it otherwise. I am thankful for it. As for those cowardly captains who deserted you, hang them up, for by God they deserve it. Yours, Du Casse"	"jean_du_casse"	"1"
"When the sword is once drawn, the passions of men observe no bounds of moderation."	"alexander_hamilton"	"2"
"Why has government been instituted at all? Because the passions of men will not conform to the dictates of reason and justice, without constraint."	"alexander_hamilton"	"3"
"Let us recollect that peace or war will not always be left to our option; that however moderate or unambitious we may be, we cannot count upon the moderation, or hope to extinguish the ambition of others."	"alexander_hamilton"	"4"
"To err is human, to forgive divine."	"alexander_pope"	"5"
"Pride, the never failing vice of fools."	"alexander_pope"	"6"
"Wars are always fought for old men, by young boys."	"anon"	"7"
"History repeats itself because no one was listening the first time."	"anon"	"8"
"We make war that we may live in peace."	"aristotle"	"9"
"The most persistent sound which reverberates through man’s history is the beating of war drums."	"arthur_koestler"	"10"
"Intellect is invisible to the man who has none."	"arthur_schopenhauer"	"11"
"Nothing except a battle lost can be half so melancholy as a battle won."	"arthur_wellesley_1"	"12"
"The hardest thing of all for a soldier is to retreat."	"arthur_wellesley_1"	"13"
"I don't know what effect these men will have upon the enemy, but by God, they frighten me."	"arthur_wellesley_1"	"14"
"Nothing except a battle lost can be half as melancholy as a battle won."	"arthur_wellesley_1"	"15"
"The whole art of war consists in getting at what is on the other side of the hill."	"arthur_wellesley_1"	"16"
"Up, Guards, and at 'em!"	"arthur_wellesley_1"	"17"
"The only thing I am afraid of is fear."	"arthur_wellesley_1"	"18"
"Hard pounding, gentlemen. Let's see who pounds the longest."	"arthur_wellesley_1"	"19"
"We always have been, we are, and I hope that we always shall be detested in France."	"arthur_wellesley_1"	"20"
"As Lord Chesterfield said of the generals of his day, 'I only hope that when the enemy reads the list of their names, he trembles as I do.'"	"arthur_wellesley_1"	"21"
"I used to say of him that his presence on the field made the difference of forty thousand men."	"arthur_wellesley_2"	"22"
"I never saw so many shocking bad hats in my life."	"arthur_wellesley_3"	"23"
"Strange, that I came into the world with nothing, and now I am going away with this stupendous caravan of sin! Wherever I look, I see only God… I have sinned terribly, and I do not know what punishment awaits me."	"aurangzeb"	"24"
"The measure of a man's character is what he would do if he knew he never would be found out."	"thomas_babington_macaulay"	"25"
"I have been apt to think that there has never been, nor ever will be, any such thing as a good war, or a bad peace."	"benjamin_franklin"	"26"
"They who can give up essential liberty to obtain a little temporary safety, deserve neither liberty nor safety."	"benjamin_franklin"	"27"
"He that would live in peace and at ease, must not speak all he knows or all he sees."	"benjamin_franklin"	"28"
"Even peace may be purchased at too high a price."	"benjamin_franklin"	"29"
"'Tis a common observation here that our cause is the cause of all mankind, and that we are fighting for their liberty in defending our own."	"benjamin_franklin"	"30"
"You may delay, but time will not."	"benjamin_franklin"	"31"
"Words may show a man's wit, but actions his meaning."	"benjamin_franklin"	"32"
"There is no kind of dishonesty into which otherwise good people more easily and frequently fall than that of defrauding the government."	"benjamin_franklin"	"33"
"Man will ultimately be governed by God or by tyrants."	"benjamin_franklin"	"34"
"In this world nothing is certain but death and taxes."	"benjamin_franklin"	"35"
"Democracy is two wolves and a lamb voting on what to have for lunch."	"benjamin_franklin"	"36"
"By failing to prepare, you are preparing to fail."	"benjamin_franklin"	"37"
"All mankind is divided into three classes: those that are immovable, those that are movable, and those that move."	"benjamin_franklin"	"38"
"I have lived, Sir, a long time, and the longer I live, the more convincing proofs I see of this truth - that God Governs the affairs of men. And if a sparrow cannot fall to the ground without His notice, is it probable that an empire can rise without His aid?"	"benjamin_franklin"	"40"
"To be thrown upon one's own resources, is to be cast into the very lap of fortune; for our faculties then undergo a development and display an energy of which they were previously unsusceptible."	"benjamin_franklin"	"41"
"Rule 1, on page 1 of the book of war, is: 'Do not march on Moscow'… Rule 2 is: 'Do not go fighting with your land armies in China.'"	"bernard_law_montgomery"	"42"
"War always finds a way."	"bertolt_brecht"	"43"
"War is nothing but a duel on a larger scale."	"carl_von_clausewitz"	"44"
"The greatest enemy of a good plan is the dream of a perfect plan."	"carl_von_clausewitz"	"45"
"No one starts a war - or rather, no one in his senses ought to do so - without first being clear in his mind what he intends to achieve by that war, and how he intends to conduct it."	"carl_von_clausewitz"	"46"
"Close combat, man to man, is plainly to be regarded as the real basis of combat."	"carl_von_clausewitz"	"47"
"War is nothing but a continuation of politics with the admixture of other means."	"carl_von_clausewitz"	"48"
"The great uncertainty of all data in war is because all action, to a certain extent, planned in a mere twilight - like the effect of a fog - gives things exaggerated dimensions and unnatural appearance."	"carl_von_clausewitz"	"49"
"For a soldier I listed, to grow great in fame, And be shot at for six-pence a day."	"charles_dibdin"	"50"
"I die happy."	"charles_fox"	"51"
"Stand by me, my brave grenadiers!"	"charles_lee"	"52"
"I speak Spanish to God, Italian to women, French to men, and German to my horse."	"charles_V"	"53"
"I have resolved never to start an unjust war, but never to end a legitimate one except by defeating my enemies."	"charles_XII_1"	"54"
"Don’t be afraid!"	"charles_XII_2"	"55"
"War is too much a serious thing to be left to military men."	"charles_de_talleyrand"	"56"
"Mistrust first impulses, they are nearly always good."	"charles_de_talleyrand"	"57"
"Cedant arma togae, concedant laurea laudi. (Let war yield to peace, laurels to paeans.)"	"cicero"	"58"
"Nervos belli, pecuniam infinitam. (The sinews of war, unlimited money.)"	"cicero"	"59"
"Silent enim leges inter arma. (Laws are silent in times of war.)"	"cicero"	"60"
"An army must inevitably consist of the scum of the people and all those for which society has no use."	"saint_germain"	"61"
"Is this dying? Is this all? Is this what I feared when I prayed against a hard death? Oh, I can bear this! I can bear this!"	"cotton_mather"	"62"
"We have won a victory, but may I never see such another."	"maurice_de_saxe"	"63"
"Let all brave Prussians follow me!"	"count_von_sedgewick"	"64"
"Oh dear…"	"david_garrick"	"65"
"There is no true sovereign except the nation; there can be no true legislator except the people."	"denis_diderot"	"66"
"I am about to - or I am going to - die; either expression is correct."	"dominique_bouhours"	"67"
"In war, indeed, there can be no substitute for victory."	"douglas_macarthur"	"68"
"The violence of war admits no distinction; the lance, that is lifted at guilt and power, will sometimes fall on innocence and gentleness."	"samuel_johnson"	"69"
"Patriotism is the last refuge of a scoundrel."	"samuel_johnson"	"70"
"Much may be made of a Scotchman, if he be caught young."	"samuel_johnson"	"71"
"To a people warlike and indigent, an incursion into a rich country is never hurtful."	"samuel_johnson"	"72"
"Nothing will ever be attempted, if all possible objections must be first overcome."	"samuel_johnson"	"73"
"No man will be a sailor who has contrivance enough to get himself into a jail; for being in a ship is being in jail, with a chance of being drowned…A man in jail has more room, better food, and commonly better company."	"samuel_johnson"	"74"
"Liberty, too, must be limited in order to be possessed."	"edmund_burke"	"75"
"You can never play the future by the past."	"edmund_burke"	"76"
"When bad men combine, the good must associate else they will fall one by one, an unpitied sacrifice in a contemptible struggle."	"edmund_burke"	"77"
"All that is necessary for the triumph of evil is that good men do nothing."	"edmund_burke"	"78"
"I venture to say no war can be long carried on against the will of the people."	"edmund_burke"	"79"
"Wars are just to those to whom they are necessary."	"edmund_burke"	"80"
"We improve ourselves by victories over ourself. There must be contests, and you must win."	"edward_gibbon"	"81"
"History is indeed little more than the register of the crimes, follies, and misfortunes of mankind."	"edward_gibbon"	"82"
"As long as mankind shall continue to bestow more liberal applause on their destroyers than on their benefactors, the thirst of military glory will ever be the vice of the most exalted characters."	"edward_gibbon"	"83"
"The Lord is a man of war."	"exodus"	"84"
"It is your attitude, and the suspicion that you are maturing the boldest designs against him, that imposes on your enemy."	"frederick_the_great"	"85"
"Without supplies no army is brave."	"frederick_the_great"	"86"
"Rascals, do you want to live forever?"	"frederick_the_great"	"87"
"The most certain way of ensuring victory is to march briskly and in good order against the enemy, always endeavouring to gain ground."	"frederick_the_great"	"88"
"Everything which the enemy least expects will succeed the best."	"frederick_the_great"	"89"
"Artillery adds dignity to what would otherwise be an ugly brawl."	"frederick_the_great"	"90"
"Do not forget your dogs of war, your big guns, which are the most-to-be respected arguments of the rights of kings."	"frederick_the_great"	"91"
"If soldiers were to begin to think, not one of them would remain in the army."	"frederick_the_great"	"92"
"A defensive war is apt to betray us into too frequent detachment. Those generals who have had but little experience attempt to protect every point, while those who are better acquainted with their profession, having only the capital object in view, guard against a decisive blow, and acquiesce in small misfortunes to avoid greater."	"frederick_the_great"	"93"
"We are made for action, and activity is the sovereign remedy for all physical ills."	"frederick_the_great"	"94"
"The Empress Catherine and I are simple robbers. I just would like to know how the Empress Maria-Theresa calmed down her father confessor? She cried when she took; the more she cried, the more she took!?"	"frederick_the_great"	"95"
"The most beautiful girl or woman in the world would be a matter of indifference to me, but tall soldiers - they are my weakness."	"frederick_william_1"	"96"
"No, not quite naked. I shall have my uniform on."	"frederick_william_2"	"97"
"He who fights with monsters might take care lest he thereby become a monster. And if you gaze for long into an abyss, the abyss gazes also into you."	"friedrich_nietsche"	"98"
"Against stupidity the gods themselves struggle in vain."	"friedrich_von_schiller"	"99"
"A historian is a prophet in reverse."	"friedrich_von_schlegel"	"100"
"Mad, is he? Then I hope that he will bite some of my other generals!"	"george_III"	"101"
"War is peace. Freedom is slavery. Ignorance is strength."	"george_orwell"	"102"
"To be prepared for war is one of the most effectual means of preserving peace."	"george_washington_1"	"103"
"War - an act of violence whose object is to constrain the enemy, to accomplish our will."	"george_washington_1"	"104"
"Over-grown military establishments are under any form of government inauspicious to liberty, and are to be regarded as particularly hostile to republican liberty."	"george_washington_1"	"105"
"My first wish is to see this plague of mankind, war, banished from the earth."	"george_washington_1"	"106"
"Discipline is the soul of an army. It makes small numbers formidable, procures success to the weak, and esteem to all."	"george_washington_1"	"107"
"Every post is honourable in which a man can serve his country."	"george_washington_1"	"108"
"To place any dependence upon militia, is, assuredly, resting upon a broken staff."	"george_washington_1"	"109"
"Government is not reason; it is not eloquent; it is force. Like fire, it is a dangerous servant and a fearful master."	"george_washington_1"	"110"
"The constitution vests the power of declaring war in Congress; therefore no offensive expedition of importance can be undertaken until after they shall have deliberated upon the subject and authorized such a measure."	"george_washington_1"	"111"
"T'is well."	"george_washington_2"	"112"
"I would rather wear out than rust out."	"george_whitefield"	"113"
"Show my head to the people. It is worth seeing."	"georges_danton"	"114"
"I have lived as a philosopher and die as a Christian."	"giacomo_casanova"	"115"
"Men rush to arms for slight causes, or no cause at all, and once taken up there is no longer any respect for law, divine or human."	"huig_de_groot"	"116"
"Prudence approaches, conscience accuses."	"immanuel_kant"	"117"
"In law a man is guilty when he violates the rights of others. In ethics he is guilty if he only thinks of doing so."	"immanuel_kant"	"118"
"Science is organized knowledge. Wisdom is organized life."	"immanuel_kant"	"119"
"So act that your principle of action might safely be made a law for the whole world."	"immanuel_kant"	"120"
"Ultima Ratio Regum. (The final argument of kings.)"	"inscription_cannon"	"121"
"Men are wise in proportion, not to their experience, but to their capacity for experience."	"james_boswell"	"122"
"Tell the men to fire faster and not to give up the ship; fight her till she sinks."	"james_lawrence"	"123"
"You give me a credit to which I have no claim in calling me 'the writer of the Constitution of the United States'. This was not, like the fabled Goddess of Wisdom, the offspring of a single brain. It ought to be regarded as the work of many heads and many hands."	"james_madison"	"124"
"A popular Government without popular information nor the means of acquiring it, is but a Prologue to a Farce or a Tragedy or perhaps both. Knowledge will forever govern ignorance, and a people who mean to be their own Governors must arm themselves with the power knowledge gives."	"james_madison"	"125"
"It was by the sober sense of our citizens that we were safely and steadily conducted from monarchy to republicanism, and it is by the same agency alone we can be kept from falling back."	"james_madison"	"126"
"Knowledge will forever govern ignorance, and a people who mean to be their own Governors must arm themselves with the power knowledge gives."	"james_madison"	"127"
"Don’t give up the ship!"	"james_mugford"	"128"
"What, do they run already? Then I die happy."	"james_wolfe_2"	"130"
"Duty is heavier than iron, yet death is lighter than a feather."	"japanese_proverb"	"131"
"They shall all be guillotined."	"jean_paul_marat"	"132"
"You must either conquer and rule or serve and lose, suffer or triumph, be the anvil or the hammer."	"johann_von_goethe"	"133"
"Divide and rule, a sound motto. Unite and lead, a better one."	"johann_von_goethe"	"134"
"The essence of war is violence. Moderation in war is imbecility."	"john_arbuthnot_fisher"	"135"
"If tyranny and oppression come to this land, it will be in the guise of fighting a foreign enemy."	"john_adams_1"	"136"
"Great is the guilt of an unnecessary war."	"john_adams_1"	"137"
"We're in a war, dammit! We're going to have to offend somebody!"	"john_adams_1"	"138"
"I am well aware of the toil and blood and treasure that it will cost to maintain this Declaration, and support and defend these States. Yet through all the gloom I can see the rays of ravishing light and glory. I can see that the end is worth more than the means."	"john_adams_1"	"139"
"I must study politics and war that my sons may have liberty to study mathematics and philosophy."	"john_adams_1"	"140"
"For God's Sake be sure you do not risk the cannon."	"john_churchill"	"141"
"War is the trade of kings."	"john_dryden"	"142"
"I would sooner fail than not be among the greatest."	"john_keats"	"143"
"New opinions are always suspected, and usually opposed, without any other reason but because they are not already common."	"john_locke"	"144"
"All men are liable to error; and most men are, in many points, by passion or interest, under temptation to it."	"john_locke"	"145"
"None can love freedom heartily, but good men; the rest love not freedom, but licence."	"john_milton"	"146"
"Who overcomes by force, hath overcome but half his foe."	"john_milton"	"147"
"I have not yet begun to fight!"	"john_paul_jones"	"148"
"What? Men dodging this way for single bullets? What will you do when they open fire along the whole line? I am ashamed of you. They couldn't hit an elephant at this distance…"	"john_sedgwick"	"149"
"My voice is still for war."	"joseph_addison"	"150"
"From hence, let fierce contending nations know, what dire effects from civil discord flow."	"joseph_addison"	"151"
"Every nation has the government that it deserves."	"joseph_de_maistre"	"152"
"I die."	"leonard_euler"	"153"
"Gentlemen of France, perhaps you would care to fire first?"	"lord_hay"	"154"
"You must consider every man your enemy who speaks ill of your King, and you must treat every Frenchman as if he were the Devil himself."	"lord_nelson_1"	"155"
"No captain can do very wrong if he places his ship alongside that of the enemy."	"lord_nelson_1"	"156"
"England expects that every man will do his duty."	"lord_nelson_2"	"157"
"Thank God I have done my duty."	"lord_nelson_3"	"158"
"First feelings are always the most natural."	"louis_XIV"	"160"
"I die innocent of all the crimes laid to my charge; I pardon those who have occasioned my death; and I pray to God that the blood you are going to shed may never be visited on France."	"louis_XVI_1"	"161"
"Oh Liberty! Liberty! What crimes are committed in your name!"	"madame_roland"	"162"
"In an age that is utterly corrupt, the best policy is to do as others do."	"marquis_de_sade"	"163"
"I have seen what I never thought to be possible - a single line of infantry break through three lines of cavalry ranks, in order of battle, and tumble them to ruin."	"marquis_de_contades"	"164"
"It has all been most interesting."	"mary_wortley"	"165"
"An army marches on its stomach."	"napoleon_bonaparte"	"166"
"You must not fight too often with one enemy, or you will teach him all your art of war."	"napoleon_bonaparte"	"167"
"Remember, gentlemen, what a Roman emperor said: \"The corpse of an enemy always smells sweet.\""	"napoleon_bonaparte"	"169"
"Charges of cavalry are equally useful at the beginning, the middle and the end of a battle. They should be made always, if possible, on the flanks of the infantry, especially when the latter is engaged in front."	"napoleon_bonaparte"	"170"
"Artillery is more essential to cavalry than to infantry, because cavalry has no fire for its defence, but depends on the sabre."	"napoleon_bonaparte"	"171"
"Between a battle lost and a battle won, the distance is immense and there stand empires."	"napoleon_bonaparte"	"172"
"Soldiers! Here is the battle you have so long desired! Henceforth victory depends on you; we have need of it."	"napoleon_bonaparte"	"173"
"In revolution there are only two sorts of men, those who cause them and those who profit by them."	"napoleon_bonaparte"	"174"
"Imagination rules the world."	"napoleon_bonaparte"	"175"
"Soldiers generally win battles; generals get credit for them."	"napoleon_bonaparte"	"176"
"You must not fear death, my lads; defy him, and you drive him into the enemy's ranks."	"napoleon_bonaparte"	"177"
"In war the simplest manoeuvres are the best."	"napoleon_bonaparte"	"178"
"Ability is nothing without opportunity."	"napoleon_bonaparte"	"179"
"Glory is fleeting, but obscurity is forever."	"napoleon_bonaparte"	"180"
"Read over and over again the campaigns of Alexander, Hannibal, Caesar, Gustavus, Turenne, Eugene and Frederic… This is the only way to become a great general and master the secrets of the art of war."	"napoleon_bonaparte"	"181"
"In war, three-quarters turns on personal character and relations; the balance of manpower and materials counts only for the remaining quarter."	"napoleon_bonaparte"	"182"
"I have only one regret, that I have only one life to give for my country."	"nathan_hale"	"183"
"War ought to be the only study of a prince. He ought to consider peace only as a breathing-time, which gives him leisure to contrive, and furnishes ability to execute military plans."	"niccolò_machiavelli"	"184"
"We English are good at forgiving our enemies; it releases us from the obligation of liking our friends."	"phyllis_dorothy_james"	"185"
"The battle, Sir, is not to the strong alone; it is to the vigilant, the active, the brave."	"patrick_henry"	"186"
"Is life so dear or peace so sweet as to be purchased at the price of chains and slavery? Forbid it, Almighty God!"	"patrick_henry"	"187"
"If we were base enough to desire it, it is now too late to retire from the contest. There is no retreat but in submission and slavery! Our chains are forged! Their clanking may be heard on the plains of Boston! The war is inevitable; and let it come! I repeat, Sir, let it come!"	"patrick_henry"	"188"
"Is life so dear, or peace so sweet, as to be purchased at the price of chains and slavery? Forbid it, Almighty God! I know not what course others may take; but as for me, give me liberty or give me death!"	"patrick_henry"	"189"
"Duty and dereliction guide thee back to solitude."	"percy_shelley"	"190"
"It's magnificent, but it's not war."	"pierre_bosquet"	"191"
"One minute can decide the outcome of the battle, one hour - the outcome of the campaign, and one day - the fate of the country."	"aleksandr_suvorov"	"192"
"Win with ability, not with numbers."	"aleksandr_suvorov"	"193"
"Accustom yourself to tireless activity."	"aleksandr_suvorov"	"194"
"When the enemy is driven back, we have failed, and when he is cut off, encircled and dispersed, we have succeeded."	"aleksandr_suvorov"	"195"
"The bullet is a mad thing, only the bayonet knows what it is about."	"aleksandr_suvorov"	"196"
"The Church will pray to God for the dead. The survivor has honour and glory."	"aleksandr_suvorov"	"197"
"The more comfort, the less courage there is."	"aleksandr_suvorov"	"198"
"If we had not driven them into hell, hell would have swallowed us."	"aleksandr_suvorov"	"199"
"When a man is able to take abuse with a smile, he is worthy to become a leader."	"reb_nachman"	"201"
"What two ideas are more inseparable than Beer and Britannia?"	"sydney_smith"	"202"
"There's only one truth about war: people die."	"richard_brinsley_sheridan"	"203"
"It is well that war is so terrible. We should grow too fond of it."	"robert_e_lee"	"204"
"Let us do evil, that good may come?"	"romans"	"205"
"The country shall be independent, and we will be satisfied with nothing short of it."	"samuel_adams_1"	"207"
"If ye love wealth better than liberty, the tranquility of servitude better than the animating contest of freedom, go home from us in peace. We ask not your counsels or arms. Crouch down and lick the hands which feed you. May your chains set lightly upon you, and may posterity forget ye were our countrymen."	"samuel_adams_1"	"208"
"Both regiments or none."	"samuel_adams_1"	"209"
"By push of bayonets, no firing until you see the whites in their eyes!"	"andrew_agnew"	"210"
"The British Army should be a projectile to be fired by the British Navy."	"edward_grey"	"211"
"I seem to have been only a boy playing on the seashore and diverting myself in now and then finding a smoother pebble or prettier shell than ordinary, while the ocean of truth lay undiscovered before me."	"isaac_newton"	"212"
"Nothing is so evident...as that war is inconsistent with the prosperity of a modern state"	"james_steuart"	"213"
"Hail to the chief in triumph advances."	"walter_scott"	"214"
"All war is deception."	"sun_tzu"	"215"
"The best victory is when the opponent surrenders of its own accord before there are any actual hostilities...It is best to win without fighting."	"sun_tzu"	"216"
"Victorious warriors win first and then go to war, while defeated warriors go to war first and then seek to win."	"sun_tzu"	"217"
"One need not destroy one's enemy. One need only destroy his willingness to engage."	"sun_tzu"	"218"
"Know the enemy and know yourself; in a hundred battles you will never be in peril."	"sun_tzu"	"219"
"To capture the enemy's entire army is better than to destroy it; to take intact a regiment, a company, or a squad is better than to destroy them. For to win one hundred victories in one hundred battles is not the supreme of excellence. To subdue the enemy without fighting is the supreme excellence."	"sun_tzu"	"220"
"This does not mean that the enemy is to be allowed to escape. The object is to make him believe that there is a road to safety, and thus prevent his fighting with the courage of despair. After that, you may crush him."	"sun_tzu"	"221"
"Think what thousands fell in vain, Wasted with disease and anguish, Not in glorious battle slain."	"admiral_hosiers_ghost"	"222"
"I see that you have made three spelling mistakes."	"thomas_de_mahay"	"223"
"War makes rattling good history; but Peace is poor reading."	"thomas_hardy"	"224"
"Ben Battle was a soldier bold, and used to war's alarms, But a cannon-ball took off his legs, so he laid down his arms."	"thomas_hood"	"225"
"For here I leave my second leg, And the Forty-Second Foot."	"thomas_hood"	"226"
"Beer is proof that God wants us to be happy."	"thomas_jefferson_1"	"227"
"The Constitution only gives people the right to pursue happiness. You have to catch it yourself."	"thomas_jefferson_1"	"228"
"It is reasonable that everyone who asks justice should do justice."	"thomas_jefferson_1"	"229"
"From time to time, the tree of liberty must be watered with the blood of tyrants and patriots."	"thomas_jefferson_1"	"230"
"The price of freedom is eternal vigilance."	"thomas_jefferson_1"	"231"
"In matters of style swim with the current, in matters of principle stand like a rock."	"thomas_jefferson_1"	"232"
"Peace and friendship with all mankind is our wisest policy, and I wish we may be permitted to pursue it."	"thomas_jefferson_1"	"234"
"War is an instrument entirely inefficient toward redressing wrong; and multiplies, instead of indemnifying losses."	"thomas_jefferson_1"	"235"
"If ever there was a holy war, it was that which saved our liberties and gave us independence."	"thomas_jefferson_1"	"236"
"We prefer war in all cases to tribute under any form and to any people whatever."	"thomas_jefferson_1"	"237"
"I have seen enough of one war never to wish to see another."	"thomas_jefferson_1"	"238"
"The greatest [calamity] which could befall [us would be] submission to a government of unlimited powers."	"thomas_jefferson_1"	"239"
"This is the fourth?"	"thomas_jefferson_2"	"241"
"The harder the conflict, the more glorious the triumph."	"thomas_paine"	"242"
"Government, even in its best state, is but a necessary evil; in its worst state, an intolerable one."	"thomas_paine"	"243"
"Character is much easier kept than recovered."	"thomas_paine"	"244"
"Those who expect to reap the blessings of freedom must, like men, undergo the fatigue of supporting it."	"thomas_paine"	"245"
"Lead, follow, or get out of the way."	"thomas_paine"	"246"
"From such beginnings of governments, what could be expected, but a continual system of war and extortion?"	"thomas_paine"	"247"
"The cunning of the fox is as murderous as the violence of the wolf."	"thomas_paine"	"248"
"The history of the present King of Great Britain is a history of repeated injuries and usurpations, all having in direct object the establishment of an absolute Tyranny over these States."	"declaration_of_independence"	"249"
"Qui desiderat pacem, praeparet bellum. (Let him who desires peace, prepare for war.)"	"vegetius"	"250"
"No problem can stand the assault of sustained thinking."	"voltaire_1"	"251"
"Those who can make you believe absurdities can make you commit atrocities."	"voltaire_1"	"252"
"God is not on the side of the big battalions, but on the side of those who shoot best."	"voltaire_1"	"253"
"Where some states possess an army, the Prussian Army possesses a state."	"voltaire_1"	"254"
"In this country we find it pays to shoot an admiral from time to time to encourage the others."	"voltaire_1"	"255"
"I disapprove of what you say, but I will defend to the death your right to say it."	"voltaire_1"	"256"
"Fear comes from uncertainty. When we are absolutely certain, whether of our worth or worthlessness, we are almost impervious to fear."	"william_congreve"	"258"
"Admirals extolled for standing still, or doing nothing with a deal of skill."	"william_cowper_1"	"259"
"War's a game, which, were their subjects wise, Kings would not play at."	"william_cowper_2"	"260"
"A noisy man is always in the right."	"william_cowper_2"	"261"
"There is one certain means by which I can be sure never to see my country's ruin: I will die in the last ditch."	"william_III"	"262"
"The air of England is too pure for a slave to breathe, and so everyone who breathes it becomes free. Everyone who comes to this island is entitled to the protection of English law, whatever oppression he may have suffered and whatever may be the colour of his skin."	"lord_mansfield"	"263"
"Where a goat can go, a man can go, where a man can go, he can drag a gun."	"william_phillips"	"264"
"If I were an American, as I am an Englishman, while a foreign troop was landed in my country, I would never lay down my arms - never - never - never!"	"pitt_the_elder"	"265"
"Where laws end, tyranny begins."	"pitt_the_elder"	"266"
"Oh, my country! How I leave my country!"	"pitt_the_younger"	"267"
"Never do today what you can put off 'til tomorrow."	"william_pulteney"	"268"
"Let me have war, say I; it exceeds peace as far as day does night; it’s spritely, waking, audible, and full of vent."	"william_shakespeare"	"269"
"Cry 'Havoc!', and let slip the dogs of war!"	"william_shakespeare"	"270"
"Those entrusted with arms should be persons of some substance and stake in the country."	"william_windham"	"271"
"Not without hope we suffer and we mourn."	"william_wordsworth"	"272"
"Strongest minds are often those whom the noisy world hears least."	"william_wordsworth"	"273"
"The good die first, and they whose hearts are dry as summer burn to the socket."	"william_wordsworth"	"274"
"Like an army defeated the snow hath retreated."	"william_wordsworth"	"275"
"Louis XVI of France: \"Is it a revolt?\" A Duke of France: \"No, Sir, it's a revolution.\""	"louis_XVI_2"	"276"
"There are so few who can grow old with a good grace."	"richard_steele"	"277"
"No one can guarantee success in war, but only deserve it."	"winston_churchill"	"278"
"No truly great man ever thought himself so."	"william_hazlitt"	"279"
"Remorse, the fatal egg by pleasure laid."	"william_cowper_2"	"280"
"Glory built on selfish principles is shame and guilt."	"william_cowper_2"	"281"
"Never esteem men on account of their riches or their station. Respect goodness, find it where you may."	"william_cobbett"	"282"
"There is no mistake so great as the mistake of not going on."	"william_blake"	"283"
"A truth that's told with bad intent beats all the lies you can invent."	"william_blake"	"284"
"I love fun, but too much is abominable."	"william_blake"	"285"
"It is easier to forgive an enemy than to forgive a friend."	"william_blake"	"286"
"Fable convenue (Fable agreed upon)"	"voltaire_3"	"287"
"When we are planning for posterity, we ought to remember that virtue is not hereditary."	"thomas_paine"	"288"
"The first duty of man is that of subduing fear."	"thomas_carlyle"	"289"
"Surtout, pas de zéle (Above all, no zeal)"	"charles_maurice_talleyrand_2"	"290"
"I am more afraid of an army of a hundred sheep led by a lion than an army of a hundred lions led by a sheep."	"charles_de_talleyrand"	"291"
"The love of glory can only create a great hero; the contempt of it creates a great man."	"charles_de_talleyrand"	"292"
"La parole nous a été donnée pour déguiser notre pensée (We were given speech to hide our thoughts)"	"charles_de_talleyrand"	"293"
"Celui qui n'a pas vécu au dix-huitième siècle avant la Révolution ne connaît pas la douceur de vivre (Those who haven't lived in the eighteenth century before the Revolution do not know the sweetness of living)"	"charles_de_talleyrand"	"294"
"I always fear that creation will expire before teatime."	"sydney_smith"	"295"
"Whatever you are by nature, keep to it; never desert your line of talent. Be what nature intended you for and you will succeed."	"sydney_smith"	"296"
"Never try to reason the prejudice out of a man. It was not reasoned into him, and cannot be reasoned out."	"sydney_smith"	"297"
"Self-confidence is the first requisite to great undertakings."	"samuel_johnson"	"298"
"Hope is necessary in every condition."	"samuel_johnson"	"299"
"Haste is good only for catching flies."	"russian_proverb"	"300"
"A wet man does not fear rain."	"russian_proverb"	"301"
"I am absolutely undone."	"richard_brinsley_sheridan_2"	"302"
"La garde meurt et ne se rend pas (The guard dies, it does not surrender)"	"pierre_cambronne"	"303"
"Man is a military animal; glories in gunpowder and loves parades."	"philip_james_bailey"	"304"
"An economist is a surgeon with an excellent scalpel and a rough-edged lancet, who operates beautifully on the dead and tortures the living."	"nicolas_chamfort"	"305"
"That man made me miss my destiny."	"napoleon_bonaparte"	"306"
"It is cowardly to commit suicide. The English often kill themselves. It is a malady caused by the humid climate."	"napoleon_bonaparte"	"307"
"There are only two forces that unite men: fear and interest."	"napoleon_bonaparte"	"308"
"Nothing is more difficult, and therefore more precious, than to be able to decide."	"napoleon_bonaparte"	"309"
"In victory, you deserve champagne; in defeat, you need it."	"napoleon_bonaparte"	"310"
"Impossible is a word to be found only in the dictionary of fools."	"napoleon_bonaparte"	"311"
"When soldiers brave death, they drive him into the enemy's ranks."	"napoleon_bonaparte"	"313"
"Religion is what keeps the poor from murdering the rich."	"napoleon_bonaparte"	"314"
"What my enemies call a general peace is my destruction. What I call peace is merely the disarmament of my enemies. Am I not more moderate than they?"	"napoleon_bonaparte"	"315"
"War justifies everything."	"napoleon_bonaparte"	"316"
"War is cruel to the people, and terrible to the conquered."	"napoleon_bonaparte"	"317"
"Victory and disaster establish indestructible bonds between armies and their commanders."	"napoleon_bonaparte"	"318"
"To extraordinary circumstance we must apply extraordinary remedies."	"napoleon_bonaparte"	"319"
"There are no bad regiments; there are only bad colonels."	"napoleon_bonaparte"	"320"
"Prussia was hatched from a cannon ball."	"napoleon_bonaparte"	"321"
"A victorious general must know how to employ severity, justness, and mildness by turns, if he would allay sedition or prevent it."	"napoleon_bonaparte"	"322"
"When defending itself against another country, a nation never lacks men, but too often, soldiers."	"napoleon_bonaparte"	"323"
"You cannot stop me; I spend thirty thousand men a month."	"napoleon_bonaparte"	"324"
"Man, not men, is the most important consideration."	"napoleon_bonaparte"	"325"
"The mind of a general ought to resemble and be as clear as the field-glass of a telescope."	"napoleon_bonaparte"	"326"
"The best way to keep one's word is not to give it."	"napoleon_bonaparte"	"327"
"The art of land warfare is an art of genius, of inspiration. On the sea nothing is genius or inspiration; everything is positive or empiric."	"napoleon_bonaparte"	"328"
"The allies we gain by victory will turn against us upon the bare whisper of our defeat."	"napoleon_bonaparte"	"329"
"The admiral needs only one science, that of navigation. The general needs all the sciences."	"napoleon_bonaparte"	"330"
"Power is my mistress. I have worked too hard at her conquest to allow anyone to take her away from me."	"napoleon_bonaparte"	"331"
"Nothing is so important in war as an undivided command."	"napoleon_bonaparte"	"332"
"Never interrupt your enemy when he is making a mistake."	"napoleon_bonaparte"	"333"
"It is with artillery that war is made."	"napoleon_bonaparte"	"334"
"It is not set speeches at the moment of battle that render soldiers brave."	"napoleon_bonaparte"	"335"
"It is exceptional and difficult to find in one man all the qualities necessary for a great general."	"napoleon_bonaparte"	"336"
"Insubordination may only be the evidence of a strong mind."	"napoleon_bonaparte"	"337"
"In war, men are nothing, one man is everything."	"napoleon_bonaparte"	"338"
"In war, as in love, we must come into contact before we triumph."	"napoleon_bonaparte"	"339"
"In politics, absurdity is not a handicap."	"napoleon_bonaparte"	"340"
"I have fought sixty battles, and I have learnt nothing which I did not know at the beginning."	"napoleon_bonaparte"	"341"
"I engage and after that I see what to do."	"napoleon_bonaparte"	"342"
"History is the version of past events that people have decided to agree upon."	"napoleon_bonaparte"	"343"
"He who fears being conquered is sure of defeat."	"napoleon_bonaparte"	"344"
"Great ambition is the passion of a great character. Those endowed with it may perform very good or very bad acts. All depends on the principles which direct them."	"napoleon_bonaparte"	"345"
"Good infantry is without doubt the sinews of an army; but if it has to fight a long time against very superior artillery, it will become demoralized and will be destroyed."	"napoleon_bonaparte"	"346"
"From these pyramids, forty centuries gaze down upon you."	"napoleon_bonaparte"	"347"
"Every means should be taken to attach the soldier to his colours."	"napoleon_bonaparte"	"348"
"England is a nation of shopkeepers."	"napoleon_bonaparte"	"349"
"Death is nothing, but to live defeated and inglorious is to die daily."	"napoleon_bonaparte"	"350"
"Better to have a known enemy than a forced ally."	"napoleon_bonaparte"	"351"
"At the head of an army, nothing is more becoming than simplicity."	"napoleon_bonaparte"	"352"
"An army must have but one line of operations. This must be maintained with care and abandoned only for major reasons."	"napoleon_bonaparte"	"353"
"An army marches on its stomach."	"napoleon_bonaparte"	"354"
"All generals, officers, and soldiers who capitulate in battle to save their own lives should be decimated."	"napoleon_bonaparte"	"355"
"A starving army is actually worse than none."	"napoleon_bonaparte"	"356"
"A soldier will fight long and hard for a bit of coloured ribbon."	"napoleon_bonaparte"	"357"
"A revolution is an idea which has found its bayonets."	"napoleon_bonaparte"	"358"
"A leader is a dealer in hope."	"napoleon_bonaparte"	"359"
"Crime butchers innocence to secure a throne, and innocence struggles with all its might against the attempts of crime."	"max_robespierre"	"360"
"It is only when aggression is legitimate that one can expect prodigies of valour."	"michel_ney"	"361"
"Nothing is more intolerable than to have to admit to yourself your own errors."	"ludwig_van"	"362"
"Anyone who tells a lie has not a pure heart, and cannot make a good soup."	"ludwig_van"	"363"
"To know how to wait is the great secret of success."	"joseph_de_maistre"	"364"
"All are born to observe order, but few are born to establish it."	"joseph_joubert"	"365"
"Here lies one whose name was writ in water."	"john_keats_2"	"366"
"No price is too great to preserve the health of the fleet."	"john_jervis"	"367"
"Impotent hatred is the most horrible of all emotions; one should hate nobody whom one cannot destroy."	"johann_von_goethe"	"368"
"The first and last thing required of genius is the love of truth."	"johann_von_goethe"	"369"
"In the realm of ideas, everything depends on enthusiasm. In the real world all rests on perseverance."	"johann_von_goethe"	"370"
"Doubt grows with knowledge."	"johann_von_goethe"	"371"
"When ideas fail, words come in very handy."	"johann_von_goethe"	"372"
"There is nothing worse than aggressive stupidity."	"johann_von_goethe"	"373"
"Correction does much, but encouragement does more. Encouragement after censure is as the sun after a shower."	"johann_von_goethe"	"374"
"A dinner which ends without cheese is like a beautiful woman with only one eye."	"ja_brillat_savarin"	"375"
"Like the greatest virtue and the worst dogs, the fiercest hatred is silent."	"jean_paul_richter"	"376"
"The best armour is to keep out of gunshot."	"italian_proverb"	"377"
"To do nothing was disgraceful; therefore I made use of my understanding."	"lord_nelson_4"	"378"
"What the country needs is the annihilation of the enemy."	"lord_nelson_1"	"379"
"Laurels grow in the Bay of Biscay, I hope a bed of them may be found in the Mediterranean."	"lord_nelson_1"	"380"
"Hardy, I do believe they have done it at last… my backbone is shot through."	"lord_nelson_1"	"381"
"Frigates are the eyes of a fleet."	"lord_nelson_1"	"382"
"First gain the victory and then make the best use of it you can."	"lord_nelson_1"	"383"
"Duty is the great business of a sea officer; all private considerations must give way to it, however painful it may be."	"lord_nelson_1"	"384"
"Desperate affairs require desperate remedies."	"lord_nelson_1"	"385"
"A ship's a fool to fight a fort."	"lord_nelson_1"	"386"
"One should forgive one's enemies, but not before they are hanged."	"heinrich_heine"	"387"
"The people are that part of the state that does not know what it wants."	"hegel_gwf"	"388"
"L'Ennemi ne s'endort (The enemy never sleeps)"	"french_proverb"	"389"
"Au royaume des aveugles les borgnes sont rois (In the kingdom of the blind the one-eyed are kings)"	"french_proverb"	"390"
"Attaque, toujours l'attaque (The attack, always the attack)"	"french_proverb"	"391"
"Aide-toi, le ciel t'aidera (Help yourself and heaven will help you)"	"french_proverb"	"392"
"A vieux comptes nouvelles disputes (Old accounts breed new disputes)"	"french_proverb"	"393"
"Opinions founded on prejudice are always sustained with the greatest of violence."	"francis_jeffrey"	"394"
"Total war is the most humane in the long run."	"lewis_strength"	"395"
"The age of chivalry is gone; and that of sophisters, economists, and calculators has succeeded."	"burke_reflections"	"396"
"How wonderful is Death? Death, and his brother Sleep!"	"shelley_mab"	"397"
"Oh, what a tangled web we weave when first we practice to deceive!"	"scott_mamion"	"398"
"We wage no war with women nor with priests.`"	"southey_madoc"	"399"
"As soon as you trust yourself, you will know how to live."	"goethe_faust"	"400"
"Hope for the best but prepare for the worst."	"english_proverb"	"401"
"The more a leader is in the habit of demanding from his men, the surer he will be that his demands will be answered."	"carl_von_clausewitz"	"402"
"The heart of France lies between Brussels and Paris."	"carl_von_clausewitz"	"403"
"Never forget that no military leader has ever become great without audacity."	"carl_von_clausewitz"	"404"
"Desperate affairs require desperate remedies."	"carl_von_clausewitz"	"405"
"Battles decide everything."	"carl_von_clausewitz"	"406"
"The only thing that they can be relied on to do is to gallop too far and too fast."	"arthur_wellesley_5"	"407"
"He is no gentleman."	"arthur_wellesley_2"	"408"
"There is nothing on earth so stupid as a gallant officer."	"arthur_wellesley_1"	"409"
"The British soldiers are fellows who have all enlisted for drink. That is the plain fact - they have all enlisted for drink."	"arthur_wellesley_1"	"410"
"Next to a lost battle, nothing is so sad as a battle that has been won."	"arthur_wellesley_1"	"411"
"It is not the business of generals to shoot one another."	"arthur_wellesley_4"	"412"
"Do the business of the day in the day."	"arthur_wellesley_1"	"413"
"Believe me, every man you see in a military uniform is not a hero."	"arthur_wellesley_1"	"414"
"All the business of war, and indeed all the business of life, is to endeavour to find out what you don't know by what you do; that's what I called \"guessing what was on the other side of the hill\"."	"arthur_wellesley_1"	"415"
"A great country cannot wage a little war."	"arthur_wellesley_1"	"416"
"Talent hits a target no one else can hit; genius hits a target no one else can see."	"arthur_schopenhauer"	"417"
"Every nation ridicules other nations, and all are right."	"arthur_schopenhauer"	"418"
"All truth passes through three stages. First, it is ridiculed. Second, it is violently opposed. Third, it is accepted as being self-evident."	"arthur_schopenhauer"	"419"
"A great captain can only be formed by long experience and intense study."	"archduke_charles"	"420"
"Go my friend, dispatch poor Vasiliky, that these dogs may not profane her beauteous form."	"ali_pasha"	"421"
"Liberté, égalité, fraternité (Liberty, equality, fraternity)"	"french_revolution"	"422"
"You sir, have an army. We have a travelling brothel."	"french_officer"	"423"
