version 3, schema avatar_aesthetics_localised_source_lookups_tables, guid 531f935b-2c94-4f28-b91d-bd09b203338e
unknown1(string)	unknown2(optstring)
"achievement_achievement_without_honour"	"ACHIEVEMENT_C_WIN_EASY_CAMPAIGN"
"achievement_advanced_firearms"	"ACHIEVEMENT_C_RESEARCH_GUNPOWDER_TECH_FIRST"
"achievement_against_all_odds"	"ACHIEVEMENT_WIN_LEGENDARY_CAMPAIGN"
"achievement_agent_stealthy_blade"	"ACHIEVEMENT_C_MAX_LEVEL_NINJA"
"achievement_army_on_the_march"	"ACHIEVEMENT_B_WIN_25_LAND_BATTLES"
"achievement_balanced_attacker"	"ACHIEVEMENT_B_WIN_BATTLE_EVERY_TYPE_OF_UNIT"
"achievement_battlefield_dominance"	"ACHIEVEMENT_B_HOLD_ALL_KEY_BUILDINGS_2_MINS"
"achievement_belligerent_admiral"	"ACHIEVEMENT_C_SINK_CARAVEL_OR_NIHON_MARU"
"achievement_berserk_charge"	"ACHIEVEMENT_B_WIN_BATTLE_NO_RANGED"
"achievement_bringer_of_death"	"ACHIEVEMENT_B_WIN_20_RANKED_BATTLES"
"achievement_carve_a_path"	"ACHIEVEMENT_A_CAPTURE_15_AVATAR_CAMPAIGN_REGIONS"
"achievement_castle_stormer"	"ACHIEVEMENT_B_WIN_10_ATTACKING_SIEGES"
"achievement_chosokabe_victory"	"ACHIEVEMENT_C_WIN_CHOSOKABE_CAMPAIGN"
"achievement_claw_of_the_tiger"	"ACHIEVEMENT_B_WIN_25_RANKED_BATTLES"
"achievement_commander_of_commoners"	"ACHIEVEMENT_B_4_ASHIGARU_UNITS_WHOLE_BATTLE"
"achievement_date_victory"	"ACHIEVEMENT_C_WIN_DATE_CAMPAIGN"
"achievement_dishonoured_foe"	"ACHIEVEMENT_C_WIN_MP_VS_CAMPAIGN_GIVING_OTHER_PLAYER_GOLD"
"achievement_divine_right"	"ACHIEVEMENT_C_BECOME_SHOGUN"
"achievement_dragon_of_japan"	"ACHIEVEMENT_B_WIN_100_RANKED_BATTLES"
"achievement_elusive_strikeforce"	"ACHIEVEMENT_B_ALL_UNITS_HIDDEN"
"achievement_eradicate_the_iga"	"ACHIEVEMENT_C_IGA_CLAN"
"achievement_eradicate_the_ikko_ikki"	"ACHIEVEMENT_C_WIPE_OUT_IKKO_IKKI"
"achievement_exceptional_warriors"	"ACHIEVEMENT_A_VETERAN_UNIT_LEVEL_5"
"achievement_experienced_taisho"	"ACHIEVEMENT_B_PLAY_10_BATTLES"
"achievement_famed_shogun"	"ACHIEVEMENT_C_WIN_HARD_CAMPAIGN"
"achievement_fear_no_horseman"	"ACHIEVEMENT_B_WIN_BATTLE_NO_SPEAR"
"achievement_fearsome_commander_of_men"	"ACHIEVEMENT_C_MAX_LEVEL_GENERAL"
"achievement_forged_in_the_hottest_flame"	"ACHIEVEMENT_B_WIN_MP_BATTLE"
"achievement_gathering_storm"	"ACHIEVEMENT_B_WIN_BATTLE_NO_CAVALRY"
"achievement_glittering_grand_cities"	"ACHIEVEMENT_C_RESEARCH_EPIC_ARCHITECTURE_FIRST"
"achievement_headhunter"	"ACHIEVEMENT_C_KILL_10000_ENEMY_SOLDIERS"
"achievement_heroic_warriors"	"ACHIEVEMENT_A_VETERAN_UNIT_LEVEL_10"
"achievement_hojo_victory"	"ACHIEVEMENT_C_WIN_CAMPAIGN_AS_HOJO"
"achievement_holder_of_kyushu"	"ACHIEVEMENT_C_CONTROL_KYUSHU"
"achievement_holder_of_shikoku"	"ACHIEVEMENT_C_CONTROL_SHIKOKU"
"achievement_inspiring_counterattack"	"ACHIEVEMENT_B_RALLY_5_UNITS"
"achievement_japan_torn_assunder"	"ACHIEVEMENT_C_WIN_MP_VS_CAMPAIGN"
"achievement_legendary_force"	"ACHIEVEMENT_B_FIELD_ENTIRELY_HEROES"
"achievement_legendary_sohei"	"ACHIEVEMENT_C_MAX_LEVEL_MONK"
"achievement_living_for_battle"	"ACHIEVEMENT_C_OBTAIN_MAX_LEVEL_UNIT"
"achievement_loyal_to_the_clan"	"ACHIEVEMENT_A_EARN_20_CLAN_TOKENS"
"achievement_man_the_defences"	"ACHIEVEMENT_B_WIN_10_DEFENDING_SIEGES"
"achievement_master_interrogator"	"ACHIEVEMENT_C_MAX_LEVEL_METSUKE"
"achievement_master_of_the_waves"	"ACHIEVEMENT_B_WIN_20_NAVAL_BATTLES"
"achievement_military_might"	"ACHIEVEMENT_C_RESEARCH_SHIH_TECH_FIRST"
"achievement_mori_victory"	"ACHIEVEMENT_C_WIN_MORI_CAMPAIGN"
"achievement_oda_victory"	"ACHIEVEMENT_C_WIN_CAMPAIGN_AS_ODA"
"achievement_one_rule_under_god"	"ACHIEVEMENT_C_WIN_GAME_AS_CHRISTIAN"
"achievement_onna_bugeisha"	"ACHIEVEMENT_B_WIN_BATTLE_ONNA_BUGEISHA_AS_GENERAL"
"achievement_path_of_the_leader"	"ACHIEVEMENT_A_MAX_OUT_AVATAR_SKILLS_TREE"
"achievement_respectable_rule"	"ACHIEVEMENT_C_WIN_MEDIUM_CAMPAIGN"
"achievement_servant_of_god"	"ACHIEVEMENT_C_MAX_LEVEL_MISSIONARY"
"achievement_serve_with_honour"	"ACHIEVEMENT_A_JOIN_A_CLAN"
"achievement_shimazu_victory"	"ACHIEVEMENT_C_WIN_SHIMAZU_CAMPAIGN"
"achievement_soaring_fame"	"ACHIEVEMENT_C_OBTAIN_100_FAME_IN_20_TURNS"
"achievement_spreading_like_wildfire"	"ACHIEVEMENT_B_BEAT_CA_STAFF_VIRAL"
"achievement_stranglehold"	"ACHIEVEMENT_A_5_CLAN_REGIONS_SIMULTANEOUSLY_OWNED"
"achievement_stubborn_pursuer_of_victory"	"ACHIEVEMENT_WIN_HARD_CAMPAIGN"
"achievement_swathed_in_fire"	"ACHIEVEMENT_B_WIN_BATTLE_50_PERCENT_MATCHLOCK"
"achievement_swift_and_deadly"	"ACHIEVEMENT_B_WIN_MP_BATTLE_LESS_THAN_15_PERCENT_LOSSES"
"achievement_takeda_victory"	"ACHIEVEMENT_C_WIN_CAMPAIGN_AS_TAKEDA"
"achievement_there_can_be_only_one"	"ACHIEVEMENT_RANK_1_SHOGUN_LADDER"
"achievement_tokugawa_victory"	"ACHIEVEMENT_C_WIN_CAMPAIGN_AS_TOKUGAWA"
"achievement_trade_route_monopoly"	"ACHIEVEMENT_C_POSESS_ALL_TRADE_NODES"
"achievement_uesugi_victory"	"ACHIEVEMENT_C_WIN_UESUGI_CAMPAIGN"
"achievement_united_in_conquest"	"ACHIEVEMENT_C_WIN_MP_COOP_CAMPAIGN"
"achievement_uniter_of_japan"	"ACHIEVEMENT_A_CAPTURE_ALL_AVATAR_CAMPAIGN_REGIONS"
"achievement_unnecessary_force"	"ACHIEVEMENT_B_WIPE_OUT_A_UNIT"
"achievement_zenlike_dedication"	"ACHIEVEMENT_B_WIN_200_MULTIPLAYER_BATTLES"
"armour_set"	nil
"battle"	nil
"campaign"	nil
"clan_comp_promotion"	nil
"clan_comp_tier_1_promotion"	nil
"clan_comp_winner"	nil
"ikko_ikki_pdlc_source"	nil
"placeholder"	nil
"starting"	nil
