version 1, schema uniforms_tables
unknown1(string)	unknown2(string)	unknown3(string)	unknown4(string)
"Austria_Art_Fix_Austrian_Rocket_Troop"	"austria"	"Austria_Art_Fix_Austrian_Rocket_Troop"	"Art_Fix_Austrian_Rocket_Troop"
"Austria_Art_Foot_Austrian_12_lber"	"austria"	"Austria_Art_Foot_Austrian_12_lber"	"Art_Foot_Austrian_12_lber"
"Austria_Art_Foot_Austrian_6_lber"	"austria"	"Austria_Art_Foot_Austrian_6_lber"	"Art_Foot_Austrian_6_lber"
"Austria_Art_Foot_Austrian_7_lber_Howitzer"	"austria"	"Austria_Art_Foot_Austrian_7_lber_Howitzer"	"Art_Foot_Austrian_7_lber_Howitzer"
"Austria_Art_Foot_Austrian_Experimental_Howitzer"	"austria"	"Austria_Art_Foot_Austrian_Experimental_Howitzer"	"Art_Foot_Austrian_Experimental_Howitzer"
"Austria_Cav_Heavy_Austrian_Cuirassiers"	"austria"	"Austria_Cav_Heavy_Austrian_Cuirassiers"	"Cav_Heavy_Austrian_Cuirassiers"
"Austria_Cav_Heavy_Austrian_Dragoons"	"austria"	"Austria_Cav_Heavy_Austrian_Dragoons"	"Cav_Heavy_Austrian_Dragoons"
"Austria_Cav_Lancer_Austrian_Ulans"	"austria"	"Austria_Cav_Lancer_Austrian_Ulans"	"Cav_Lancer_Austrian_Ulans"
"Austria_Cav_Light_Austrian_1st_Hussars"	"austria"	"Austria_Cav_Light_Austrian_1st_Hussars"	"Cav_Light_Austrian_1st_Hussars"
"Austria_Cav_Light_Austrian_Hungarian_Hussars"	"austria"	"Austria_Cav_Light_Austrian_Hungarian_Hussars"	"Cav_Light_Austrian_Hungarian_Hussars"
"Austria_Cav_Stand_Austrian_Chevauxlegers"	"austria"	"Austria_Cav_Stand_Austrian_Chevauxlegers"	"Cav_Stand_Austrian_Chevauxlegers"
"Austria_Gen_Archduke_Charles"	"austria"	"Austria_Gen_Archduke_Charles"	"Gen_Archduke_Charles"
"Austria_Gen_Generals_Staff"	"austria"	"Austria_Gen_Generals_Staff"	"Gen_Generals_Staff"
"Austria_Gen_Jozsef_Alvinczi"	"austria"	"Austria_Gen_Jozsef_Alvinczi"	"Gen_Jozsef_Alvinczi"
"Austria_Gen_Karl_Schwarzenberg"	"austria"	"Austria_Gen_Karl_Schwarzenberg"	"Gen_Karl_Schwarzenberg"
"Austria_Inf_Gren_Austrian_German_Grenadiers"	"austria"	"Austria_Inf_Gren_Austrian_German_Grenadiers"	"Inf_Gren_Austrian_German_Grenadiers"
"Austria_Inf_Gren_Austrian_Hungarian_Grenadiers"	"austria"	"Austria_Inf_Gren_Austrian_Hungarian_Grenadiers"	"Inf_Gren_Austrian_Hungarian_Grenadiers"
"Austria_Inf_Light_Austrian_Grenzers"	"austria"	"Austria_Inf_Light_Austrian_Grenzers"	"Inf_Light_Austrian_Grenzers"
"Austria_Inf_Line_Austrian_1st_Emperors_Own"	"austria"	"Austria_Inf_Line_Austrian_1st_Emperors_Own"	"Inf_Line_Austrian_1st_Emperors_Own"
"Austria_Inf_Line_Austrian_47th_Czech"	"austria"	"Austria_Inf_Line_Austrian_47th_Czech"	"Inf_Line_Austrian_47th_Czech"
"Austria_Inf_Line_Austrian_German_Fusiliers"	"austria"	"Austria_Inf_Line_Austrian_German_Fusiliers"	"Inf_Line_Austrian_German_Fusiliers"
"Austria_Inf_Line_Austrian_Hungarian_Fusiliers"	"austria"	"Austria_Inf_Line_Austrian_Hungarian_Fusiliers"	"Inf_Line_Austrian_Hungarian_Fusiliers"
"Austria_Inf_Militia_Austrian_Landesschutzen"	"austria"	"Austria_Inf_Militia_Austrian_Landesschutzen"	"Inf_Militia_Austrian_Landesschutzen"
"Austria_Inf_Militia_Austrian_Landwehr"	"austria"	"Austria_Inf_Militia_Austrian_Landwehr"	"Inf_Militia_Austrian_Landwehr"
"Austria_Inf_Mob_Armed_Citizenry"	"austria"	"Austria_Inf_Mob_Armed_Citizenry"	"Inf_Mob_Armed_Citizenry"
"Austria_Inf_Skirm_Austrian_Jager"	"austria"	"Austria_Inf_Skirm_Austrian_Jager"	"Inf_Skirm_Austrian_Jager"
"Austria_Inf_Skirm_Austrian_Windbucshe_Jager"	"austria"	"Austria_Inf_Skirm_Austrian_Windbucshe_Jager"	"Inf_Skirm_Austrian_Windbucshe_Jager"
"Austrian_Rebels_Art_Foot_12_lber"	"austrian_rebels"	"Austrian_Rebels_Art_Foot_12_lber"	"Art_Foot_12_lber"
"Austrian_Rebels_Art_Foot_7_lber_Howitzer"	"austrian_rebels"	"Austrian_Rebels_Art_Foot_7_lber_Howitzer"	"Art_Foot_7_lber_Howitzer"
"Austrian_Rebels_Art_Horse_6_lber"	"austrian_rebels"	"Austrian_Rebels_Art_Horse_6_lber"	"Art_Horse_6_lber"
"Austrian_Rebels_Cav_Heavy_Dragoons"	"austrian_rebels"	"Austrian_Rebels_Cav_Heavy_Dragoons"	"Cav_Heavy_Dragoons"
"Austrian_Rebels_Cav_Lancer_Lancers"	"austrian_rebels"	"Austrian_Rebels_Cav_Lancer_Lancers"	"Cav_Lancer_Lancers"
"Austrian_Rebels_Cav_Light_Hussars"	"austrian_rebels"	"Austrian_Rebels_Cav_Light_Hussars"	"Cav_Light_Hussars"
"Austrian_Rebels_Cav_Stand_Chevauxlegers"	"austrian_rebels"	"Austrian_Rebels_Cav_Stand_Chevauxlegers"	"Cav_Stand_Chevauxlegers"
"Austrian_Rebels_Gen_Generals_Staff"	"austrian_rebels"	"Austrian_Rebels_Gen_Generals_Staff"	"Gen_Generals_Staff"
"Austrian_Rebels_Inf_Gren_Grenadiers"	"austrian_rebels"	"Austrian_Rebels_Inf_Gren_Grenadiers"	"Inf_Gren_Grenadiers"
"Austrian_Rebels_Inf_Light_Light_Infantry"	"austrian_rebels"	"Austrian_Rebels_Inf_Light_Light_Infantry"	"Inf_Light_Light_Infantry"
"Austrian_Rebels_Inf_Line_Line_Infantry"	"austrian_rebels"	"Austrian_Rebels_Inf_Line_Line_Infantry"	"Inf_Line_Line_Infantry"
"Austrian_Rebels_Inf_Militia_Landwehr"	"austrian_rebels"	"Austrian_Rebels_Inf_Militia_Landwehr"	"Inf_Militia_Landwehr"
"Austrian_Rebels_Inf_Mob_Armed_Citizenry"	"austrian_rebels"	"Austrian_Rebels_Inf_Mob_Armed_Citizenry"	"Inf_Mob_Armed_Citizenry"
"Austrian_Rebels_Inf_Skirm_Jager"	"austrian_rebels"	"Austrian_Rebels_Inf_Skirm_Jager"	"Inf_Skirm_Jager"
"Bavaria_Art_Foot_12_lber"	"bavaria"	"Bavaria_Art_Foot_12_lber"	"Art_Foot_12_lber"
"Bavaria_Art_Foot_6_lber"	"bavaria"	"Bavaria_Art_Foot_6_lber"	"Art_Foot_6_lber"
"Bavaria_Art_Foot_7_lber_Howitzer"	"bavaria"	"Bavaria_Art_Foot_7_lber_Howitzer"	"Art_Foot_7_lber_Howitzer"
"Bavaria_Art_Horse_6_lber"	"bavaria"	"Bavaria_Art_Horse_6_lber"	"Art_Horse_6_lber"
"Bavaria_Cav_Heavy_Cuirassiers"	"bavaria"	"Bavaria_Cav_Heavy_Cuirassiers"	"Cav_Heavy_Cuirassiers"
"Bavaria_Cav_Heavy_Dragoons"	"bavaria"	"Bavaria_Cav_Heavy_Dragoons"	"Cav_Heavy_Dragoons"
"Bavaria_Cav_Stand_Chevauxlegers"	"bavaria"	"Bavaria_Cav_Stand_Chevauxlegers"	"Cav_Stand_Chevauxlegers"
"Bavaria_Gen_Generals_Staff"	"bavaria"	"Bavaria_Gen_Generals_Staff"	"Gen_Generals_Staff"
"Bavaria_Inf_Elite_Life_Regiment"	"bavaria"	"Bavaria_Inf_Elite_Life_Regiment"	"Inf_Elite_Life_Regiment"
"Bavaria_Inf_Elite_Republican_Guards"	"bavaria"	"Bavaria_Inf_Elite_Republican_Guards"	"Inf_Elite_Republican_Guards"
"Bavaria_Inf_Gren_Grenadiers"	"bavaria"	"Bavaria_Inf_Gren_Grenadiers"	"Inf_Gren_Grenadiers"
"Bavaria_Inf_Light_Light_Infantry"	"bavaria"	"Bavaria_Inf_Light_Light_Infantry"	"Inf_Light_Light_Infantry"
"Bavaria_Inf_Line_Line_Infantry"	"bavaria"	"Bavaria_Inf_Line_Line_Infantry"	"Inf_Line_Line_Infantry"
"Bavaria_Inf_Militia_Landwehr"	"bavaria"	"Bavaria_Inf_Militia_Landwehr"	"Inf_Militia_Landwehr"
"Bavaria_Inf_Mob_Armed_Citizenry"	"bavaria"	"Bavaria_Inf_Mob_Armed_Citizenry"	"Inf_Mob_Armed_Citizenry"
"Bavaria_Inf_Skirm_Jager"	"bavaria"	"Bavaria_Inf_Skirm_Jager"	"Inf_Skirm_Jager"
"Belgium_Art_Foot_12_lber"	"belgium"	"Belgium_Art_Foot_12_lber"	"Art_Foot_12_lber"
"Belgium_Art_Foot_6_lber"	"belgium"	"Belgium_Art_Foot_6_lber"	"Art_Foot_6_lber"
"Belgium_Art_Foot_7_lber_Howitzer"	"belgium"	"Belgium_Art_Foot_7_lber_Howitzer"	"Art_Foot_7_lber_Howitzer"
"Belgium_Art_Horse_6_lber"	"belgium"	"Belgium_Art_Horse_6_lber"	"Art_Horse_6_lber"
"Belgium_Cav_Heavy_Carabiniers"	"belgium"	"Belgium_Cav_Heavy_Carabiniers"	"Cav_Heavy_Carabiniers"
"Belgium_Cav_Light_Hussars"	"belgium"	"Belgium_Cav_Light_Hussars"	"Cav_Light_Hussars"
"Belgium_Cav_Stand_Chevauxlegers"	"belgium"	"Belgium_Cav_Stand_Chevauxlegers"	"Cav_Stand_Chevauxlegers"
"Belgium_Gen_Generals_Staff"	"belgium"	"Belgium_Gen_Generals_Staff"	"Gen_Generals_Staff"
"Belgium_Inf_Gren_Grenadiers"	"belgium"	"Belgium_Inf_Gren_Grenadiers"	"Inf_Gren_Grenadiers"
"Belgium_Inf_Light_Dutch_Flanquers"	"belgium"	"Belgium_Inf_Light_Dutch_Flanquers"	"Inf_Light_Dutch_Flanquers"
"Belgium_Inf_Line_Line_Infantry"	"belgium"	"Belgium_Inf_Line_Line_Infantry"	"Inf_Line_Line_Infantry"
"Belgium_Inf_Militia_Militia"	"belgium"	"Belgium_Inf_Militia_Militia"	"Inf_Militia_Militia"
"Belgium_Inf_Mob_Armed_Citizenry"	"belgium"	"Belgium_Inf_Mob_Armed_Citizenry"	"Inf_Mob_Armed_Citizenry"
"Britain_Art_Fix_British_Rocket_Troop"	"britain"	"Britain_Art_Fix_British_Rocket_Troop"	"Art_Fix_British_Rocket_Troop"
"Britain_Art_Foot_British_5_In_Howitzer"	"britain"	"Britain_Art_Foot_British_5_In_Howitzer"	"Art_Foot_British_5_In_Howitzer"
"Britain_Art_Foot_British_6_lber"	"britain"	"Britain_Art_Foot_British_6_lber"	"Art_Foot_British_6_lber"
"Britain_Art_Foot_British_9_lber"	"britain"	"Britain_Art_Foot_British_9_lber"	"Art_Foot_British_9_lber"
"Britain_Art_Foot_British_Experimental_Howitzer"	"britain"	"Britain_Art_Foot_British_Experimental_Howitzer"	"Art_Foot_British_Experimental_Howitzer"
"Britain_Art_Horse_British_6_lber"	"britain"	"Britain_Art_Horse_British_6_lber"	"Art_Horse_British_6_lber"
"Britain_Cav_Heavy_British_Dragoon_Guards"	"britain"	"Britain_Cav_Heavy_British_Dragoon_Guards"	"Cav_Heavy_British_Dragoon_Guards"
"Britain_Cav_Heavy_British_Dragoons"	"britain"	"Britain_Cav_Heavy_British_Dragoons"	"Cav_Heavy_British_Dragoons"
"Britain_Cav_Heavy_British_Horse_Guards"	"britain"	"Britain_Cav_Heavy_British_Horse_Guards"	"Cav_Heavy_British_Horse_Guards"
"Britain_Cav_Heavy_British_Horse_Guards_Uxbridge"	"britain"	"Britain_Cav_Heavy_British_Horse_Guards_Uxbridge"	"Cav_Heavy_British_Horse_Guards_Uxbridge"
"Britain_Cav_Heavy_British_KGL_Dragoons"	"britain"	"Britain_Cav_Heavy_British_KGL_Dragoons"	"Cav_Heavy_British_KGL_Dragoons"
"Britain_Cav_Heavy_British_Life_Guards"	"britain"	"Britain_Cav_Heavy_British_Life_Guards"	"Cav_Heavy_British_Life_Guards"
"Britain_Cav_Heavy_British_Royal_Scots_Greys"	"britain"	"Britain_Cav_Heavy_British_Royal_Scots_Greys"	"Cav_Heavy_British_Royal_Scots_Greys"
"Britain_Cav_Heavy_Republican_Horse_Guards"	"britain"	"Britain_Cav_Heavy_Republican_Horse_Guards"	"Cav_Heavy_Republican_Horse_Guards"
"Britain_Cav_Light_British_15th_Hussars"	"britain"	"Britain_Cav_Light_British_15th_Hussars"	"Cav_Light_British_15th_Hussars"
"Britain_Cav_Light_British_KGL_Light_Dragoons"	"britain"	"Britain_Cav_Light_British_KGL_Light_Dragoons"	"Cav_Light_British_KGL_Light_Dragoons"
"Britain_Cav_Light_British_Light_Dragoons"	"britain"	"Britain_Cav_Light_British_Light_Dragoons"	"Cav_Light_British_Light_Dragoons"
"Britain_Cav_Light_Dutch_Light_Dragoons"	"britain"	"United_Netherlands_Cav_Light_Light_Dragoons"	"Cav_Light_Dutch_Light_Dragoons"
"Britain_Gen_Duke_of_Wellington"	"britain"	"Britain_Gen_Duke_of_Wellington"	"Gen_Duke_of_Wellington"
"Britain_Gen_Generals_Staff"	"britain"	"Britain_Gen_Generals_Staff"	"Gen_Generals_Staff"
"Britain_Gen_Picton"	"britain"	"Britain_Gen_Picton"	"Gen_Picton"
"Britain_Gen_Prince_of_Orange"	"britain"	"United_Netherlands_Gen_Prince_of_Orange"	"Gen_Prince_of_Orange"
"Britain_Gen_Sir_John_Moore"	"britain"	"Britain_Gen_Sir_John_Moore"	"Gen_Sir_John_Moore"
"Britain_Inf_Elite_British_Black_Watch"	"britain"	"Britain_Inf_Elite_British_Black_Watch"	"Inf_Elite_British_Black_Watch"
"Britain_Inf_Elite_British_Foot_Guards"	"britain"	"Britain_Inf_Elite_British_Foot_Guards"	"Inf_Elite_British_Foot_Guards"
"Britain_Inf_Elite_Republican_Guards"	"britain"	"Britain_Inf_Elite_Republican_Guards"	"Inf_Elite_Republican_Guards"
"Britain_Inf_Light_British_Dutch_Flanquers"	"britain"	"United_Netherlands_Inf_Light_Dutch_Flanquers"	"Inf_Light_British_Dutch_Flanquers"
"Britain_Inf_Light_British_KGL_Light_Foot"	"britain"	"Britain_Inf_Light_British_KGL_Light_Foot"	"Inf_Light_British_KGL_Light_Foot"
"Britain_Inf_Light_British_Light_Foot"	"britain"	"Britain_Inf_Light_British_Light_Foot"	"Inf_Light_British_Light_Foot"
"Britain_Inf_Line_British_88th_Foot"	"britain"	"Britain_Inf_Line_British_88th_Foot"	"Inf_Line_British_88th_Foot"
"Britain_Inf_Line_British_Foot"	"britain"	"Britain_Inf_Line_British_Foot"	"Inf_Line_British_Foot"
"Britain_Inf_Line_British_Highland_Foot"	"britain"	"Britain_Inf_Line_British_Highland_Foot"	"Inf_Line_British_Highland_Foot"
"Britain_Inf_Line_British_KGL_Foot"	"britain"	"Britain_Inf_Line_British_KGL_Foot"	"Inf_Line_British_KGL_Foot"
"Britain_Inf_Line_Brunswick_Line_Infantry"	"britain"	"Britain_Inf_Line_Brunswick_Line_Infantry"	"Inf_Line_Brunswick_Line_Infantry"
"Britain_Inf_Line_Dutch_Line_Infantry"	"britain"	"United_Netherlands_Inf_Line_Line_Infantry"	"Inf_Line_Dutch_Line_Infantry"
"Britain_Inf_Militia_British_Fencibles"	"britain"	"Britain_Inf_Militia_British_Fencibles"	"Inf_Militia_British_Fencibles"
"Britain_Inf_Militia_Militiamen"	"britain"	"United_Netherlands_Inf_Militia_Militiamen"	"Inf_Militia_Militiamen"
"Britain_Inf_Mob_Armed_Citizenry"	"britain"	"Britain_Inf_Mob_Armed_Citizenry"	"Inf_Mob_Armed_Citizenry"
"Britain_Inf_Skirm_British_Rifles"	"britain"	"Britain_Inf_Skirm_British_Rifles"	"Inf_Skirm_British_Rifles"
"Britain_Inf_Skirm_Nassau_Jager"	"britain"	"United_Netherlands_Inf_Skirm_Jager"	"Inf_Skirm_Nassau_Jager"
"British_Rebels_Art_Foot_6_lber"	"british_rebels"	"British_Rebels_Art_Foot_6_lber"	"Art_Foot_6_lber"
"British_Rebels_Art_Foot_7_lber_Howitzer"	"british_rebels"	"British_Rebels_Art_Foot_7_lber_Howitzer"	"Art_Foot_7_lber_Howitzer"
"British_Rebels_Art_Horse_6_lber"	"british_rebels"	"British_Rebels_Art_Horse_6_lber"	"Art_Horse_6_lber"
"British_Rebels_Cav_Heavy_Dragoons"	"british_rebels"	"British_Rebels_Cav_Heavy_Dragoons"	"Cav_Heavy_Dragoons"
"British_Rebels_Cav_Light_Light_Dragoons"	"british_rebels"	"British_Rebels_Cav_Light_Light_Dragoons"	"Cav_Light_Light_Dragoons"
"British_Rebels_Gen_Generals_Staff"	"british_rebels"	"British_Rebels_Gen_Generals_Staff"	"Gen_Generals_Staff"
"British_Rebels_Inf_Light_Light_Infantry"	"british_rebels"	"British_Rebels_Inf_Light_Light_Infantry"	"Inf_Light_Light_Infantry"
"British_Rebels_Inf_Line_Line_Infantry"	"british_rebels"	"British_Rebels_Inf_Line_Line_Infantry"	"Inf_Line_Line_Infantry"
"British_Rebels_Inf_Militia_Militia"	"british_rebels"	"British_Rebels_Inf_Militia_Militia"	"Inf_Militia_Militia"
"British_Rebels_Inf_Mob_Armed_Citizenry"	"british_rebels"	"British_Rebels_Inf_Mob_Armed_Citizenry"	"Inf_Mob_Armed_Citizenry"
"Brittany_Art_Foot_12_lber"	"brittany"	"Brittany_Art_Foot_12_lber"	"Art_Foot_12_lber"
"Brittany_Art_Foot_6_lber"	"brittany"	"Brittany_Art_Foot_6_lber"	"Art_Foot_6_lber"
"Brittany_Art_Foot_7_lber_Howitzer"	"brittany"	"Brittany_Art_Foot_7_lber_Howitzer"	"Art_Foot_7_lber_Howitzer"
"Brittany_Art_Horse_6_lber"	"brittany"	"Brittany_Art_Horse_6_lber"	"Art_Horse_6_lber"
"Brittany_Cav_Heavy_Dragoons"	"brittany"	"Brittany_Cav_Heavy_Dragoons"	"Cav_Heavy_Dragoons"
"Brittany_Cav_Light_Hussars"	"brittany"	"Brittany_Cav_Light_Hussars"	"Cav_Light_Hussars"
"Brittany_Gen_Generals_Staff"	"brittany"	"Brittany_Gen_Generals_Staff"	"Gen_Generals_Staff"
"Brittany_Inf_Gren_Grenadiers"	"brittany"	"Brittany_Inf_Gren_Grenadiers"	"Inf_Gren_Grenadiers"
"Brittany_Inf_Light_Light_Infantry"	"brittany"	"Brittany_Inf_Light_Light_Infantry"	"Inf_Light_Light_Infantry"
"Brittany_Inf_Line_Line_Infantry"	"brittany"	"Brittany_Inf_Line_Line_Infantry"	"Inf_Line_Line_Infantry"
"Brittany_Inf_Militia_Militia"	"brittany"	"Brittany_Inf_Militia_Militia"	"Inf_Militia_Militia"
"Brittany_Inf_Mob_Armed_Citizenry"	"brittany"	"Brittany_Inf_Mob_Armed_Citizenry"	"Inf_Mob_Armed_Citizenry"
"Catalonia_Art_Foot_12_lber"	"catalonia"	"Catalonia_Art_Foot_12_lber"	"Art_Foot_12_lber"
"Catalonia_Art_Foot_6_lber"	"catalonia"	"Catalonia_Art_Foot_6_lber"	"Art_Foot_6_lber"
"Catalonia_Art_Foot_7_lber_Howitzer"	"catalonia"	"Catalonia_Art_Foot_7_lber_Howitzer"	"Art_Foot_7_lber_Howitzer"
"Catalonia_Art_Horse_6_lber"	"catalonia"	"Catalonia_Art_Horse_6_lber"	"Art_Horse_6_lber"
"Catalonia_Cav_Heavy_Dragoons"	"catalonia"	"Catalonia_Cav_Heavy_Dragoons"	"Cav_Heavy_Dragoons"
"Catalonia_Cav_Light_Hussars"	"catalonia"	"Catalonia_Cav_Light_Hussars"	"Cav_Light_Hussars"
"Catalonia_Gen_Generals_Staff"	"catalonia"	"Catalonia_Gen_Generals_Staff"	"Gen_Generals_Staff"
"Catalonia_Inf_Gren_Grenadiers"	"catalonia"	"Catalonia_Inf_Gren_Grenadiers"	"Inf_Gren_Grenadiers"
"Catalonia_Inf_Light_Light_Infantry"	"catalonia"	"Catalonia_Inf_Light_Light_Infantry"	"Inf_Light_Light_Infantry"
"Catalonia_Inf_Line_Line_Infantry"	"catalonia"	"Catalonia_Inf_Line_Line_Infantry"	"Inf_Line_Line_Infantry"
"Catalonia_Inf_Militia_Militia"	"catalonia"	"Catalonia_Inf_Militia_Militia"	"Inf_Militia_Militia"
"Catalonia_Inf_Mob_Armed_Citizenry"	"catalonia"	"Catalonia_Inf_Mob_Armed_Citizenry"	"Inf_Mob_Armed_Citizenry"
"Cossack_Rebels_Art_Foot_12_lber"	"cossack_rebels"	"Cossack_Rebels_Art_Foot_12_lber"	"Art_Foot_12_lber"
"Cossack_Rebels_Art_Foot_7_lber_Howitzer"	"cossack_rebels"	"Cossack_Rebels_Art_Foot_7_lber_Howitzer"	"Art_Foot_7_lber_Howitzer"
"Cossack_Rebels_Art_Horse_6_lber"	"cossack_rebels"	"Cossack_Rebels_Art_Horse_6_lber"	"Art_Horse_6_lber"
"Cossack_Rebels_Cav_Heavy_Dragoons"	"cossack_rebels"	"Cossack_Rebels_Cav_Heavy_Dragoons"	"Cav_Heavy_Dragoons"
"Cossack_Rebels_Cav_Lancer_Russian_Cossack_Cavalry"	"cossack_rebels"	"Cossack_Rebels_Cav_Lancer_Russian_Cossack_Cavalry"	"Cav_Lancer_Russian_Cossack_Cavalry"
"Cossack_Rebels_Cav_Light_Hussars"	"cossack_rebels"	"Cossack_Rebels_Cav_Light_Hussars"	"Cav_Light_Hussars"
"Cossack_Rebels_Gen_Generals_Staff"	"cossack_rebels"	"Cossack_Rebels_Gen_Generals_Staff"	"Gen_Generals_Staff"
"Cossack_Rebels_Inf_Gren_Grenadiers"	"cossack_rebels"	"Cossack_Rebels_Inf_Gren_Grenadiers"	"Inf_Gren_Grenadiers"
"Cossack_Rebels_Inf_Line_Musketeers"	"cossack_rebels"	"Cossack_Rebels_Inf_Line_Musketeers"	"Inf_Line_Musketeers"
"Cossack_Rebels_Inf_Militia_Militia"	"cossack_rebels"	"Cossack_Rebels_Inf_Militia_Militia"	"Inf_Militia_Militia"
"Cossack_Rebels_Inf_Mob_Armed_Citizenry"	"cossack_rebels"	"Cossack_Rebels_Inf_Mob_Armed_Citizenry"	"Inf_Mob_Armed_Citizenry"
"Cossack_Rebels_Inf_Skirm_Jager"	"cossack_rebels"	"Cossack_Rebels_Inf_Skirm_Jager"	"Inf_Skirm_Jager"
"Courland_Art_Foot_12_lber"	"courland"	"Courland_Art_Foot_12_lber"	"Art_Foot_12_lber"
"Courland_Art_Foot_6_lber"	"courland"	"Courland_Art_Foot_6_lber"	"Art_Foot_6_lber"
"Courland_Art_Foot_7_lber_Howitzer"	"courland"	"Courland_Art_Foot_7_lber_Howitzer"	"Art_Foot_7_lber_Howitzer"
"Courland_Art_Horse_6_lber"	"courland"	"Courland_Art_Horse_6_lber"	"Art_Horse_6_lber"
"Courland_Cav_Heavy_Dragoons"	"courland"	"Courland_Cav_Heavy_Dragoons"	"Cav_Heavy_Dragoons"
"Courland_Cav_Lancer_Lancers"	"courland"	"Courland_Cav_Lancer_Lancers"	"Cav_Lancer_Lancers"
"Courland_Cav_Light_Hussars"	"courland"	"Courland_Cav_Light_Hussars"	"Cav_Light_Hussars"
"Courland_Gen_Generals_Staff"	"courland"	"Courland_Gen_Generals_Staff"	"Gen_Generals_Staff"
"Courland_Inf_Gren_Grenadiers"	"courland"	"Courland_Inf_Gren_Grenadiers"	"Inf_Gren_Grenadiers"
"Courland_Inf_Line_Line_Infantry"	"courland"	"Courland_Inf_Line_Line_Infantry"	"Inf_Line_Line_Infantry"
"Courland_Inf_Militia_Militia"	"courland"	"Courland_Inf_Militia_Militia"	"Inf_Militia_Militia"
"Courland_Inf_Mob_Armed_Citizenry"	"courland"	"Courland_Inf_Mob_Armed_Citizenry"	"Inf_Mob_Armed_Citizenry"
"Crimean_Khanate_Art_Foot_12_lber"	"crimean_khanate"	"Crimean_Khanate_Art_Foot_12_lber"	"Art_Foot_12_lber"
"Crimean_Khanate_Art_Foot_6_lber"	"crimean_khanate"	"Crimean_Khanate_Art_Foot_6_lber"	"Art_Foot_6_lber"
"Crimean_Khanate_Cav_Heavy_Dragoons"	"crimean_khanate"	"Crimean_Khanate_Cav_Heavy_Dragoons"	"Cav_Heavy_Dragoons"
"Crimean_Khanate_Cav_Lancer_Russian_Cossack_Cavalry"	"crimean_khanate"	"Crimean_Khanate_Cav_Lancer_Russian_Cossack_Cavalry"	"Cav_Lancer_Russian_Cossack_Cavalry"
"Crimean_Khanate_Cav_Light_Hussars"	"crimean_khanate"	"Crimean_Khanate_Cav_Light_Hussars"	"Cav_Light_Hussars"
"Crimean_Khanate_Gen_Generals_Staff"	"crimean_khanate"	"Crimean_Khanate_Gen_Generals_Staff"	"Gen_Generals_Staff"
"Crimean_Khanate_Inf_Gren_Grenadiers"	"crimean_khanate"	"Crimean_Khanate_Inf_Gren_Grenadiers"	"Inf_Gren_Grenadiers"
"Crimean_Khanate_Inf_Line_Line_Infantry"	"crimean_khanate"	"Crimean_Khanate_Inf_Line_Line_Infantry"	"Inf_Line_Line_Infantry"
"Crimean_Khanate_Inf_Militia_Militia"	"crimean_khanate"	"Crimean_Khanate_Inf_Militia_Militia"	"Inf_Militia_Militia"
"Crimean_Khanate_Inf_Mob_Armed_Citizenry"	"crimean_khanate"	"Crimean_Khanate_Inf_Mob_Armed_Citizenry"	"Inf_Mob_Armed_Citizenry"
"Crimean_Khanate_Inf_Skirm_Jager"	"crimean_khanate"	"Crimean_Khanate_Inf_Skirm_Jager"	"Inf_Skirm_Jager"
"Denmark_Art_Foot_12_lber"	"denmark"	"Denmark_Art_Foot_12_lber"	"Art_Foot_12_lber"
"Denmark_Art_Foot_6_lber"	"denmark"	"Denmark_Art_Foot_6_lber"	"Art_Foot_6_lber"
"Denmark_Art_Foot_7_lber_Howitzer"	"denmark"	"Denmark_Art_Foot_7_lber_Howitzer"	"Art_Foot_7_lber_Howitzer"
"Denmark_Art_Horse_6_lber"	"denmark"	"Denmark_Art_Horse_6_lber"	"Art_Horse_6_lber"
"Denmark_Cav_Heavy_Dragoons"	"denmark"	"Denmark_Cav_Heavy_Dragoons"	"Cav_Heavy_Dragoons"
"Denmark_Cav_Heavy_Life_Guards_of_Horse"	"denmark"	"Denmark_Cav_Heavy_Life_Guards_of_Horse"	"Cav_Heavy_Life_Guards_of_Horse"
"Denmark_Cav_Heavy_Republican_Horse_Guards"	"denmark"	"Denmark_Cav_Heavy_Republican_Horse_Guards"	"Cav_Heavy_Republican_Horse_Guards"
"Denmark_Cav_Light_Light_Dragoons"	"denmark"	"Denmark_Cav_Light_Light_Dragoons"	"Cav_Light_Light_Dragoons"
"Denmark_Gen_Ernst_Paymann"	"denmark"	"Denmark_Gen_Ernst_Paymann"	"Gen_Ernst_Paymann"
"Denmark_Gen_Generals_Staff"	"denmark"	"Denmark_Gen_Generals_Staff"	"Gen_Generals_Staff"
"Denmark_Gen_Joachim_Melchior_Holten_Castenschiold"	"denmark"	"Denmark_Gen_Joachim_Melchior_Holten_Castenschiold"	"Gen_Joachim_Melchior_Holten_Castenschiold"
"Denmark_Gen_Prince_Frederick_of_Hessen"	"denmark"	"Denmark_Gen_Prince_Frederick_of_Hessen"	"Gen_Prince_Frederick_of_Hessen"
"Denmark_Inf_Elite_Life_Guards_of_Foot"	"denmark"	"Denmark_Inf_Elite_Life_Guards_of_Foot"	"Inf_Elite_Life_Guards_of_Foot"
"Denmark_Inf_Elite_Republican_Guards"	"denmark"	"Denmark_Inf_Elite_Republican_Guards"	"Inf_Elite_Republican_Guards"
"Denmark_Inf_Gren_Grenadiers"	"denmark"	"Denmark_Inf_Gren_Grenadiers"	"Inf_Gren_Grenadiers"
"Denmark_Inf_Line_Line_Infantry"	"denmark"	"Denmark_Inf_Line_Line_Infantry"	"Inf_Line_Line_Infantry"
"Denmark_Inf_Militia_Militia"	"denmark"	"Denmark_Inf_Militia_Militia"	"Inf_Militia_Militia"
"Denmark_Inf_Mob_Armed_Citizenry"	"denmark"	"Denmark_Inf_Mob_Armed_Citizenry"	"Inf_Mob_Armed_Citizenry"
"Denmark_Inf_Skirm_Jager"	"denmark"	"Denmark_Inf_Skirm_Jager"	"Inf_Skirm_Jager"
"Denmark_Inf_Skirm_Norwegian_Ski_Troops"	"denmark"	"Denmark_Inf_Skirm_Norwegian_Ski_Troops"	"Inf_Skirm_Norwegian_Ski_Troops"
"Denmark_Inf_Skirm_Sharpshooters"	"denmark"	"Denmark_Inf_Skirm_Sharpshooters"	"Inf_Skirm_Sharpshooters"
"Bedouin_Cav_Light_Bedouin_Camel_Warriors"	"egy_bedouin"	"Bedouin_Cav_Light_Bedouin_Camel_Warriors"	"Cav_Light_Bedouin_Camel_Warriors"
"Bedouin_Cav_Miss_Bedouin_Camel_Gunners"	"egy_bedouin"	"Bedouin_Cav_Miss_Bedouin_Camel_Gunners"	"Cav_Miss_Bedouin_Camel_Gunners"
"Bedouin_Gen_Generals_Bodyguard"	"egy_bedouin"	"Bedouin_Gen_Generals_Bodyguard"	"Gen_Generals_Bodyguard"
"Bedouin_Inf_Mob_Armed_Populace"	"egy_bedouin"	"Bedouin_Inf_Mob_Armed_Populace"	"Inf_Mob_Armed_Populace"
"Britain_Egy_Art_Foot_British_6_lber"	"egy_britain"	"Britain_Egy_Art_Foot_British_6_lber"	"Art_Foot_British_6_lber"
"Britain_Egy_Cav_Light_British_Light_Dragoons"	"egy_britain"	"Britain_Egy_Cav_Light_British_Light_Dragoons"	"Cav_Light_British_Light_Dragoons"
"Britain_Egy_Gen_Generals_Staff"	"egy_britain"	"Britain_Egy_Gen_Generals_Staff"	"Gen_Generals_Staff"
"Britain_Egy_Inf_Elite_British_Black_Watch"	"egy_britain"	"Britain_Egy_Inf_Elite_British_Black_Watch"	"Inf_Elite_British_Black_Watch"
"Britain_Egy_Inf_Elite_British_Foot_Guards"	"egy_britain"	"Britain_Egy_Inf_Elite_British_Foot_Guards"	"Inf_Elite_British_Foot_Guards"
"Britain_Egy_Inf_Line_British_Foot"	"egy_britain"	"Britain_Egy_Inf_Line_British_Foot"	"Inf_Line_British_Foot"
"Britain_Egy_Inf_Mob_Armed_Citizenry"	"egy_britain"	"Britain_Egy_Inf_Mob_Armed_Citizenry"	"Inf_Mob_Armed_Citizenry"
"French_Rep_Egy_Art_Foot_French_6_In_Howitzer"	"egy_french_republic"	"French_Rep_Egy_Art_Foot_French_6_In_Howitzer"	"Art_Foot_French_6_In_Howitzer"
"French_Rep_Egy_Art_Foot_French_6_lber"	"egy_french_republic"	"French_Rep_Egy_Art_Foot_French_6_lber"	"Art_Foot_French_6_lber"
"French_Rep_Egy_Art_Foot_French_8_lber"	"egy_french_republic"	"French_Rep_Egy_Art_Foot_French_8_lber"	"Art_Foot_French_8_lber"
"French_Rep_Egy_Art_Horse_French_6_lber"	"egy_french_republic"	"French_Rep_Egy_Art_Horse_French_6_lber"	"Art_Horse_French_6_lber"
"French_Rep_Egy_Cav_Heavy_French_Dragoons"	"egy_french_republic"	"French_Rep_Egy_Cav_Heavy_French_Dragoons"	"Cav_Heavy_French_Dragoons"
"French_Rep_Egy_Cav_Light_Bedouin_Camel_Warriors"	"egy_french_republic"	"French_Rep_Egy_Cav_Light_Bedouin_Camel_Warriors"	"Cav_Light_Bedouin_Camel_Warriors"
"French_Rep_Egy_Cav_Light_French_Chasseurs_a_Cheval"	"egy_french_republic"	"French_Rep_Egy_Cav_Light_French_Chasseurs_a_Cheval"	"Cav_Light_French_Chasseurs_a_Cheval"
"French_Rep_Egy_Cav_Miss_Bedouin_Camel_Gunners"	"egy_french_republic"	"French_Rep_Egy_Cav_Miss_Bedouin_Camel_Gunners"	"Cav_Miss_Bedouin_Camel_Gunners"
"French_Rep_Egy_Cav_Miss_French_Dromedary_Cavalry"	"egy_french_republic"	"French_Rep_Egy_Cav_Miss_French_Dromedary_Cavalry"	"Cav_Miss_French_Dromedary_Cavalry"
"French_Rep_Egy_Gen_Early_Napoleon"	"egy_french_republic"	"French_Rep_Egy_Gen_Early_Napoleon"	"Gen_Early_Napoleon"
"French_Rep_Egy_Gen_Generals_Staff"	"egy_french_republic"	"French_Rep_Egy_Gen_Generals_Staff"	"Gen_Generals_Staff"
"French_Rep_Egy_Inf_Gren_French_Grenadiers"	"egy_french_republic"	"French_Rep_Egy_Inf_Gren_French_Grenadiers"	"Inf_Gren_French_Grenadiers"
"French_Rep_Egy_Inf_Light_French_Chasseurs"	"egy_french_republic"	"French_Rep_Egy_Inf_Light_French_Chasseurs"	"Inf_Light_French_Chasseurs"
"French_Rep_Egy_Inf_Line_French_Fusiliers"	"egy_french_republic"	"French_Rep_Egy_Inf_Line_French_Fusiliers"	"Inf_Line_French_Fusiliers"
"French_Rep_Egy_Inf_Line_Line_Infantry"	"egy_french_republic"	"French_Rep_Egy_Inf_Line_Line_Infantry"	"Inf_Line_Line_Infantry"
"French_Rep_Egy_Inf_Militia_Militia"	"egy_french_republic"	"French_Rep_Egy_Inf_Militia_Militia"	"Inf_Militia_Militia"
"French_Rep_Egy_Inf_Militia_Ottoman_Libyan_Bedouin"	"egy_french_republic"	"French_Rep_Egy_Inf_Militia_Ottoman_Libyan_Bedouin"	"Inf_Militia_Ottoman_Libyan_Bedouin"
"French_Rep_Egy_Inf_Militia_Ottoman_Palestinian_Auxiliaries"	"egy_french_republic"	"French_Rep_Egy_Inf_Militia_Ottoman_Palestinian_Auxiliaries"	"Inf_Militia_Ottoman_Palestinian_Auxiliaries"
"French_Rep_Egy_Inf_Mob_Armed_Citizenry"	"egy_french_republic"	"French_Rep_Egy_Inf_Mob_Armed_Citizenry"	"Inf_Mob_Armed_Citizenry"
"Mamelukes_Art_Foot_Ottoman_9_lber"	"egy_mamelukes"	"Mamelukes_Art_Foot_Ottoman_9_lber"	"Art_Foot_Ottoman_9_lber"
"Mamelukes_Cav_Light_Mamelukes"	"egy_mamelukes"	"Mamelukes_Cav_Light_Mamelukes"	"Cav_Light_Mamelukes"
"Mamelukes_Gen_Generals_Bodyguard"	"egy_mamelukes"	"Mamelukes_Gen_Generals_Bodyguard"	"Gen_Generals_Bodyguard"
"Mamelukes_Inf_Irreg_Ottoman_Azzars"	"egy_mamelukes"	"Mamelukes_Inf_Irreg_Ottoman_Azzars"	"Inf_Irreg_Ottoman_Azzars"
"Mamelukes_Inf_Militia_Ottoman_Libyan_Bedouin"	"egy_mamelukes"	"Mamelukes_Inf_Militia_Ottoman_Libyan_Bedouin"	"Inf_Militia_Ottoman_Libyan_Bedouin"
"Mamelukes_Inf_Militia_Ottoman_Palestinian_Auxiliaries"	"egy_mamelukes"	"Mamelukes_Inf_Militia_Ottoman_Palestinian_Auxiliaries"	"Inf_Militia_Ottoman_Palestinian_Auxiliaries"
"Mamelukes_Inf_Militia_Ottoman_Peasant_Levy"	"egy_mamelukes"	"Mamelukes_Inf_Militia_Ottoman_Peasant_Levy"	"Inf_Militia_Ottoman_Peasant_Levy"
"Mamelukes_Inf_Mob_Armed_Populace"	"egy_mamelukes"	"Mamelukes_Inf_Mob_Armed_Populace"	"Inf_Mob_Armed_Populace"
"Mamelukes_Inf_Mob_Armed_Populace_Firelock"	"egy_mamelukes"	"Mamelukes_Inf_Mob_Armed_Populace_Firelock"	"Inf_Mob_Armed_Populace_Firelock"
"Ottomans_Egy_Art_Fix_Ottoman_Bombardment_Mortars"	"egy_ottomans"	"Ottomans_Egy_Art_Fix_Ottoman_Bombardment_Mortars"	"Art_Fix_Ottoman_Bombardment_Mortars"
"Ottomans_Egy_Art_Foot_Ottoman_18_lber"	"egy_ottomans"	"Ottomans_Egy_Art_Foot_Ottoman_18_lber"	"Art_Foot_Ottoman_18_lber"
"Ottomans_Egy_Art_Foot_Ottoman_9_lber"	"egy_ottomans"	"Ottomans_Egy_Art_Foot_Ottoman_9_lber"	"Art_Foot_Ottoman_9_lber"
"Ottomans_Egy_Art_Foot_Ottoman_Howitzers"	"egy_ottomans"	"Ottomans_Egy_Art_Foot_Ottoman_Howitzers"	"Art_Foot_Ottoman_Howitzers"
"Ottomans_Egy_Cav_Heavy_Ottoman_Silahtar_Guard"	"egy_ottomans"	"Ottomans_Egy_Cav_Heavy_Ottoman_Silahtar_Guard"	"Cav_Heavy_Ottoman_Silahtar_Guard"
"Ottomans_Egy_Cav_Heavy_Ottoman_Siphai_Cavalry"	"egy_ottomans"	"Ottomans_Egy_Cav_Heavy_Ottoman_Siphai_Cavalry"	"Cav_Heavy_Ottoman_Siphai_Cavalry"
"Ottomans_Egy_Cav_Light_Mamelukes"	"egy_ottomans"	"Mamelukes_Cav_Light_Mamelukes"	"Cav_Light_Mamelukes"
"Ottomans_Egy_Cav_Light_Ottoman_Bedouin_Camel_Warriors"	"egy_ottomans"	"Ottomans_Egy_Cav_Light_Ottoman_Bedouin_Camel_Warriors"	"Cav_Light_Ottoman_Bedouin_Camel_Warriors"
"Ottomans_Egy_Cav_Light_Ottoman_Deli_Horsemen"	"egy_ottomans"	"Ottomans_Egy_Cav_Light_Ottoman_Deli_Horsemen"	"Cav_Light_Ottoman_Deli_Horsemen"
"Ottomans_Egy_Cav_Miss_Ottoman_Bedouin_Camel_Gunners"	"egy_ottomans"	"Ottomans_Egy_Cav_Miss_Ottoman_Bedouin_Camel_Gunners"	"Cav_Miss_Ottoman_Bedouin_Camel_Gunners"
"Ottomans_Egy_Cav_Miss_Ottoman_Shaturnal_Camel_Gunners"	"egy_ottomans"	"Ottomans_Egy_Cav_Miss_Ottoman_Shaturnal_Camel_Gunners"	"Cav_Miss_Ottoman_Shaturnal_Camel_Gunners"
"Ottomans_Egy_Gen_Generals_Bodyguard"	"egy_ottomans"	"Ottomans_Egy_Gen_Generals_Bodyguard"	"Gen_Generals_Bodyguard"
"Ottomans_Egy_Gen_Murad_Bey"	"egy_ottomans"	"Ottomans_Egy_Gen_Murad_Bey"	"Gen_Murad_Bey"
"Ottomans_Egy_Inf_Gren_Ottoman_Beylik_Janissary_Grenadiers"	"egy_ottomans"	"Ottomans_Egy_Inf_Gren_Ottoman_Beylik_Janissary_Grenadiers"	"Inf_Gren_Ottoman_Beylik_Janissary_Grenadiers"
"Ottomans_Egy_Inf_Irreg_Ottoman_Azzars"	"egy_ottomans"	"Ottomans_Egy_Inf_Irreg_Ottoman_Azzars"	"Inf_Irreg_Ottoman_Azzars"
"Ottomans_Egy_Inf_Irreg_Ottoman_Bashi_Bazouks"	"egy_ottomans"	"Ottomans_Egy_Inf_Irreg_Ottoman_Bashi_Bazouks"	"Inf_Irreg_Ottoman_Bashi_Bazouks"
"Ottomans_Egy_Inf_Light_Egy_Ottoman_Nizam_I_Cedit_Light_Infantry"	"egy_ottomans"	"Ottomans_Egy_Inf_Light_Egy_Ottoman_Nizam_I_Cedit_Light_Infantry"	"Inf_Light_Egy_Ottoman_Nizam_I_Cedit_Light_Infantry"
"Ottomans_Egy_Inf_Line_Egy_Ottoman_Nizam_I_Cedit_Infantry"	"egy_ottomans"	"Ottomans_Egy_Inf_Line_Egy_Ottoman_Nizam_I_Cedit_Infantry"	"Inf_Line_Egy_Ottoman_Nizam_I_Cedit_Infantry"
"Ottomans_Egy_Inf_Line_Ottoman_Beylik_Janissary_Musketeers"	"egy_ottomans"	"Ottomans_Egy_Inf_Line_Ottoman_Beylik_Janissary_Musketeers"	"Inf_Line_Ottoman_Beylik_Janissary_Musketeers"
"Ottomans_Egy_Inf_Line_Provincial_Egy_Ottoman_Nizam_I_Cedit"	"egy_ottomans"	"Ottomans_Egy_Inf_Line_Provincial_Egy_Ottoman_Nizam_I_Cedit"	"Inf_Line_Provincial_Egy_Ottoman_Nizam_I_Cedit"
"Ottomans_Egy_Inf_Melee_Ottoman_Cemaat_Janissaries"	"egy_ottomans"	"Ottomans_Egy_Inf_Melee_Ottoman_Cemaat_Janissaries"	"Inf_Melee_Ottoman_Cemaat_Janissaries"
"Ottomans_Egy_Inf_Militia_Ottoman_Libyan_Bedouin"	"egy_ottomans"	"Ottomans_Egy_Inf_Militia_Ottoman_Libyan_Bedouin"	"Inf_Militia_Ottoman_Libyan_Bedouin"
"Ottomans_Egy_Inf_Militia_Ottoman_Palestinian_Auxiliaries"	"egy_ottomans"	"Ottomans_Egy_Inf_Militia_Ottoman_Palestinian_Auxiliaries"	"Inf_Militia_Ottoman_Palestinian_Auxiliaries"
"Ottomans_Egy_Inf_Militia_Ottoman_Peasant_Levy"	"egy_ottomans"	"Ottomans_Egy_Inf_Militia_Ottoman_Peasant_Levy"	"Inf_Militia_Ottoman_Peasant_Levy"
"Ottomans_Egy_Inf_Mob_Armed_Populace"	"egy_ottomans"	"Ottomans_Egy_Inf_Mob_Armed_Populace"	"Inf_Mob_Armed_Populace"
"Ottomans_Egy_Inf_Mob_Armed_Populace_Firelock"	"egy_ottomans"	"Ottomans_Egy_Inf_Mob_Armed_Populace_Firelock"	"Inf_Mob_Armed_Populace_Firelock"
"Ottomans_Egy_Mounted_Inf_Egy_Ottoman_Mounted_Nizam_I_Cedit"	"egy_ottomans"	"Ottomans_Egy_Mounted_Inf_Egy_Ottoman_Mounted_Nizam_I_Cedit"	"Mounted_Inf_Egy_Ottoman_Mounted_Nizam_I_Cedit"
"France_Art_Fix_French_Rocket_Troop"	"france"	"France_Art_Fix_French_Rocket_Troop"	"Art_Fix_French_Rocket_Troop"
"France_Art_Foot_French_12_lber"	"france"	"France_Art_Foot_French_12_lber"	"Art_Foot_French_12_lber"
"France_Art_Foot_French_6_In_Howitzer"	"france"	"France_Art_Foot_French_6_In_Howitzer"	"Art_Foot_French_6_In_Howitzer"
"France_Art_Foot_French_6_lber"	"france"	"France_Art_Foot_French_6_lber"	"Art_Foot_French_6_lber"
"France_Art_Foot_French_8_lber"	"france"	"France_Art_Foot_French_8_lber"	"Art_Foot_French_8_lber"
"France_Art_Foot_French_Artillerie_a_Pied"	"france"	"France_Art_Foot_French_Artillerie_a_Pied"	"Art_Foot_French_Artillerie_a_Pied"
"France_Art_Foot_French_Experimental_Howitzer"	"france"	"France_Art_Foot_French_Experimental_Howitzer"	"Art_Foot_French_Experimental_Howitzer"
"France_Art_Foot_Grand_Battery_Convention"	"france"	"France_Art_Foot_Grand_Battery_Convention"	"Art_Foot_Grand_Battery_Convention"
"France_Art_Horse_French_6_lber"	"france"	"France_Art_Horse_French_6_lber"	"Art_Horse_French_6_lber"
"France_Art_Horse_French_Artillerie_a_Cheval"	"france"	"France_Art_Horse_French_Artillerie_a_Cheval"	"Art_Horse_French_Artillerie_a_Cheval"
"France_Cav_Heavy_French_Carabiniers"	"france"	"France_Cav_Heavy_French_Carabiniers"	"Cav_Heavy_French_Carabiniers"
"France_Cav_Heavy_French_Cuirassiers"	"france"	"France_Cav_Heavy_French_Cuirassiers"	"Cav_Heavy_French_Cuirassiers"
"France_Cav_Heavy_French_Cuirassiers_Murat"	"france"	"France_Cav_Heavy_French_Cuirassiers_Murat"	"Cav_Heavy_French_Cuirassiers_Murat"
"France_Cav_Heavy_French_Cuirassiers_Ney"	"france"	"France_Cav_Heavy_French_Cuirassiers_Ney"	"Cav_Heavy_French_Cuirassiers_Ney"
"France_Cav_Heavy_French_Dragoons"	"france"	"France_Cav_Heavy_French_Dragoons"	"Cav_Heavy_French_Dragoons"
"France_Cav_Heavy_French_Grenadiers_a_Cheval"	"france"	"France_Cav_Heavy_French_Grenadiers_a_Cheval"	"Cav_Heavy_French_Grenadiers_a_Cheval"
"France_Cav_Lancer_French_7th_Lancers"	"france"	"France_Cav_Lancer_French_7th_Lancers"	"Cav_Lancer_French_7th_Lancers"
"France_Cav_Lancer_French_Cheveau_Legers_Lancers"	"france"	"France_Cav_Lancer_French_Cheveau_Legers_Lancers"	"Cav_Lancer_French_Cheveau_Legers_Lancers"
"France_Cav_Light_French_5e_Hussards"	"france"	"France_Cav_Light_French_5e_Hussards"	"Cav_Light_French_5e_Hussards"
"France_Cav_Light_French_Chasseurs_a_Cheval"	"france"	"France_Cav_Light_French_Chasseurs_a_Cheval"	"Cav_Light_French_Chasseurs_a_Cheval"
"Ottomans_Cav_Light_French_Mamelukes"	"france"	"Ottomans_Cav_Light_French_Mamelukes"	"Cav_Light_Mamelukes"
"France_Gen_D_Erlon"	"france"	"France_Gen_D_Erlon"	"Gen_D_Erlon"
"France_Gen_Generals_Staff"	"france"	"France_Gen_Generals_Staff"	"Gen_Generals_Staff"
"France_Gen_Late_Napoleon"	"france"	"France_Gen_Late_Napoleon"	"Gen_Late_Napoleon"
"France_Gen_Marechal_Ney"	"france"	"France_Gen_Marechal_Ney"	"Gen_Marechal_Ney"
"France_Gen_Marechal_Soult"	"france"	"France_Gen_Marechal_Soult"	"Gen_Marechal_Soult"
"France_Inf_Elite_French_Old_Guard"	"france"	"France_Inf_Elite_French_Old_Guard"	"Inf_Elite_French_Old_Guard"
"France_Inf_Elite_French_Young_Guard"	"france"	"France_Inf_Elite_French_Young_Guard"	"Inf_Elite_French_Young_Guard"
"France_Inf_Gren_French_Grenadiers"	"france"	"France_Inf_Gren_French_Grenadiers"	"Inf_Gren_French_Grenadiers"
"France_Inf_Light_French_6th_Legere"	"france"	"France_Inf_Light_French_6th_Legere"	"Inf_Light_French_6th_Legere"
"France_Inf_Light_French_Chasseurs"	"france"	"France_Inf_Light_French_Chasseurs"	"Inf_Light_French_Chasseurs"
"France_Inf_Line_French_18th_Ligne"	"france"	"France_Inf_Line_French_18th_Ligne"	"Inf_Line_French_18th_Ligne"
"France_Inf_Line_French_Fusiliers"	"france"	"France_Inf_Line_French_Fusiliers"	"Inf_Line_French_Fusiliers"
"France_Inf_Line_Polish_Legion"	"france"	"France_Inf_Line_Polish_Legion"	"Inf_Line_Polish_Legion"
"France_Inf_Line_Swiss_Foot"	"france"	"France_Inf_Line_Swiss_Foot"	"Inf_Line_Swiss_Foot"
"France_Inf_Militia_French_National_Guard"	"france"	"France_Inf_Militia_French_National_Guard"	"Inf_Militia_French_National_Guard"
"France_Inf_Militia_Militia"	"france"	"France_Inf_Militia_Militia"	"Inf_Militia_Militia"
"France_Inf_Mob_Armed_Citizenry"	"france"	"France_Inf_Mob_Armed_Citizenry"	"Inf_Mob_Armed_Citizenry"
"France_Inf_Skirm_French_Voltiguers"	"france"	"France_Inf_Skirm_French_Voltiguers"	"Inf_Skirm_French_Voltiguers"
"French_Rebels_Art_Foot_12_lber"	"french_rebels"	"French_Rebels_Art_Foot_12_lber"	"Art_Foot_12_lber"
"French_Rebels_Art_Foot_7_lber_Howitzer"	"french_rebels"	"French_Rebels_Art_Foot_7_lber_Howitzer"	"Art_Foot_7_lber_Howitzer"
"French_Rebels_Art_Horse_6_lber"	"french_rebels"	"French_Rebels_Art_Horse_6_lber"	"Art_Horse_6_lber"
"French_Rebels_Cav_Heavy_Cuirassiers"	"french_rebels"	"French_Rebels_Cav_Heavy_Cuirassiers"	"Cav_Heavy_Cuirassiers"
"French_Rebels_Cav_Heavy_Dragoons"	"french_rebels"	"French_Rebels_Cav_Heavy_Dragoons"	"Cav_Heavy_Dragoons"
"French_Rebels_Cav_Light_Hussars"	"french_rebels"	"French_Rebels_Cav_Light_Hussars"	"Cav_Light_Hussars"
"French_Rebels_Gen_Generals_Staff"	"french_rebels"	"French_Rebels_Gen_Generals_Staff"	"Gen_Generals_Staff"
"French_Rebels_Inf_Gren_Grenadiers"	"french_rebels"	"French_Rebels_Inf_Gren_Grenadiers"	"Inf_Gren_Grenadiers"
"French_Rebels_Inf_Light_Light_Infantry"	"french_rebels"	"French_Rebels_Inf_Light_Light_Infantry"	"Inf_Light_Light_Infantry"
"French_Rebels_Inf_Line_Line_Infantry"	"french_rebels"	"French_Rebels_Inf_Line_Line_Infantry"	"Inf_Line_Line_Infantry"
"French_Rebels_Inf_Militia_Militia"	"french_rebels"	"French_Rebels_Inf_Militia_Militia"	"Inf_Militia_Militia"
"French_Rebels_Inf_Mob_Armed_Citizenry"	"french_rebels"	"French_Rebels_Inf_Mob_Armed_Citizenry"	"Inf_Mob_Armed_Citizenry"
"Greece_Art_Foot_12_lber"	"greece"	"Greece_Art_Foot_12_lber"	"Art_Foot_12_lber"
"Greece_Art_Foot_6_lber"	"greece"	"Greece_Art_Foot_6_lber"	"Art_Foot_6_lber"
"Greece_Art_Foot_7_lber_Howitzer"	"greece"	"Greece_Art_Foot_7_lber_Howitzer"	"Art_Foot_7_lber_Howitzer"
"Greece_Art_Horse_6_lber"	"greece"	"Greece_Art_Horse_6_lber"	"Art_Horse_6_lber"
"Greece_Cav_Heavy_Dragoons"	"greece"	"Greece_Cav_Heavy_Dragoons"	"Cav_Heavy_Dragoons"
"Greece_Cav_Light_Hussars"	"greece"	"Greece_Cav_Light_Hussars"	"Cav_Light_Hussars"
"Greece_Gen_Generals_Staff"	"greece"	"Greece_Gen_Generals_Staff"	"Gen_Generals_Staff"
"Greece_Inf_Light_Light_Infantry"	"greece"	"Greece_Inf_Light_Light_Infantry"	"Inf_Light_Light_Infantry"
"Greece_Inf_Line_Line_Infantry"	"greece"	"Greece_Inf_Line_Line_Infantry"	"Inf_Line_Line_Infantry"
"Greece_Inf_Militia_Militia"	"greece"	"Greece_Inf_Militia_Militia"	"Inf_Militia_Militia"
"Greece_Inf_Mob_Armed_Citizenry"	"greece"	"Greece_Inf_Mob_Armed_Citizenry"	"Inf_Mob_Armed_Citizenry"
"Hannover_Art_Foot_12_lber"	"hannover"	"Hannover_Art_Foot_12_lber"	"Art_Foot_12_lber"
"Hannover_Art_Foot_6_lber"	"hannover"	"Hannover_Art_Foot_6_lber"	"Art_Foot_6_lber"
"Hannover_Art_Foot_7_lber_Howitzer"	"hannover"	"Hannover_Art_Foot_7_lber_Howitzer"	"Art_Foot_7_lber_Howitzer"
"Hannover_Art_Horse_6_lber"	"hannover"	"Hannover_Art_Horse_6_lber"	"Art_Horse_6_lber"
"Hannover_Cav_Heavy_Dragoons"	"hannover"	"Hannover_Cav_Heavy_Dragoons"	"Cav_Heavy_Dragoons"
"Hannover_Cav_Heavy_Life_Guards_of_Horse"	"hannover"	"Hannover_Cav_Heavy_Life_Guards_of_Horse"	"Cav_Heavy_Life_Guards_of_Horse"
"Hannover_Cav_Heavy_Republican_Horse_Guards"	"hannover"	"Hannover_Cav_Heavy_Republican_Horse_Guards"	"Cav_Heavy_Republican_Horse_Guards"
"Hannover_Cav_Light_Hussars"	"hannover"	"Hannover_Cav_Light_Hussars"	"Cav_Light_Hussars"
"Hannover_Gen_Generals_Staff"	"hannover"	"Hannover_Gen_Generals_Staff"	"Gen_Generals_Staff"
"Hannover_Inf_Light_Light_Infantry"	"hannover"	"Hannover_Inf_Light_Light_Infantry"	"Inf_Light_Light_Infantry"
"Hannover_Inf_Line_Line_Infantry"	"hannover"	"Hannover_Inf_Line_Line_Infantry"	"Inf_Line_Line_Infantry"
"Hannover_Inf_Militia_Landwehr"	"hannover"	"Hannover_Inf_Militia_Landwehr"	"Inf_Militia_Landwehr"
"Hannover_Inf_Mob_Armed_Citizenry"	"hannover"	"Hannover_Inf_Mob_Armed_Citizenry"	"Inf_Mob_Armed_Citizenry"
"Hessen_Art_Foot_12_lber"	"hessen"	"Hessen_Art_Foot_12_lber"	"Art_Foot_12_lber"
"Hessen_Art_Foot_6_lber"	"hessen"	"Hessen_Art_Foot_6_lber"	"Art_Foot_6_lber"
"Hessen_Art_Foot_7_lber_Howitzer"	"hessen"	"Hessen_Art_Foot_7_lber_Howitzer"	"Art_Foot_7_lber_Howitzer"
"Hessen_Art_Horse_6_lber"	"hessen"	"Hessen_Art_Horse_6_lber"	"Art_Horse_6_lber"
"Hessen_Cav_Heavy_Carabiniers"	"hessen"	"Hessen_Cav_Heavy_Carabiniers"	"Cav_Heavy_Carabiniers"
"Hessen_Cav_Heavy_Garde_du_Corp"	"hessen"	"Hessen_Cav_Heavy_Garde_du_Corp"	"Cav_Heavy_Garde_du_Corp"
"Hessen_Cav_Heavy_Republican_Horse_Guards"	"hessen"	"Hessen_Cav_Heavy_Republican_Horse_Guards"	"Cav_Heavy_Republican_Horse_Guards"
"Hessen_Cav_Light_Hussars"	"hessen"	"Hessen_Cav_Light_Hussars"	"Cav_Light_Hussars"
"Hessen_Cav_Stand_Chevauxlegers"	"hessen"	"Hessen_Cav_Stand_Chevauxlegers"	"Cav_Stand_Chevauxlegers"
"Hessen_Gen_Generals_Staff"	"hessen"	"Hessen_Gen_Generals_Staff"	"Gen_Generals_Staff"
"Hessen_Inf_Elite_Grenadier_Guards"	"hessen"	"Hessen_Inf_Elite_Grenadier_Guards"	"Inf_Elite_Grenadier_Guards"
"Hessen_Inf_Elite_Republican_Guards"	"hessen"	"Hessen_Inf_Elite_Republican_Guards"	"Inf_Elite_Republican_Guards"
"Hessen_Inf_Gren_Grenadiers"	"hessen"	"Hessen_Inf_Gren_Grenadiers"	"Inf_Gren_Grenadiers"
"Hessen_Inf_Light_Fusiliers"	"hessen"	"Hessen_Inf_Light_Fusiliers"	"Inf_Light_Fusiliers"
"Hessen_Inf_Line_Musketeers"	"hessen"	"Hessen_Inf_Line_Musketeers"	"Inf_Line_Musketeers"
"Hessen_Inf_Militia_Landwehr"	"hessen"	"Hessen_Inf_Militia_Landwehr"	"Inf_Militia_Landwehr"
"Hessen_Inf_Mob_Armed_Citizenry"	"hessen"	"Hessen_Inf_Mob_Armed_Citizenry"	"Inf_Mob_Armed_Citizenry"
"Hessen_Inf_Skirm_Jager"	"hessen"	"Hessen_Inf_Skirm_Jager"	"Inf_Skirm_Jager"
"Hungary_Art_Foot_12_lber"	"hungary"	"Hungary_Art_Foot_12_lber"	"Art_Foot_12_lber"
"Hungary_Art_Foot_6_lber"	"hungary"	"Hungary_Art_Foot_6_lber"	"Art_Foot_6_lber"
"Hungary_Art_Foot_7_lber_Howitzer"	"hungary"	"Hungary_Art_Foot_7_lber_Howitzer"	"Art_Foot_7_lber_Howitzer"
"Hungary_Art_Horse_6_lber"	"hungary"	"Hungary_Art_Horse_6_lber"	"Art_Horse_6_lber"
"Hungary_Cav_Heavy_Dragoons"	"hungary"	"Hungary_Cav_Heavy_Dragoons"	"Cav_Heavy_Dragoons"
"Hungary_Cav_Light_Hussars"	"hungary"	"Hungary_Cav_Light_Hussars"	"Cav_Light_Hussars"
"Hungary_Gen_Generals_Staff"	"hungary"	"Hungary_Gen_Generals_Staff"	"Gen_Generals_Staff"
"Hungary_Inf_Gren_Grenadiers"	"hungary"	"Hungary_Inf_Gren_Grenadiers"	"Inf_Gren_Grenadiers"
"Hungary_Inf_Line_Line_Infantry"	"hungary"	"Hungary_Inf_Line_Line_Infantry"	"Inf_Line_Line_Infantry"
"Hungary_Inf_Militia_Militia"	"hungary"	"Hungary_Inf_Militia_Militia"	"Inf_Militia_Militia"
"Hungary_Inf_Mob_Armed_Citizenry"	"hungary"	"Hungary_Inf_Mob_Armed_Citizenry"	"Inf_Mob_Armed_Citizenry"
"Hungary_Inf_Skirm_Jager"	"hungary"	"Hungary_Inf_Skirm_Jager"	"Inf_Skirm_Jager"
"Ireland_Art_Foot_12_lber"	"ireland"	"Ireland_Art_Foot_12_lber"	"Art_Foot_12_lber"
"Ireland_Art_Foot_6_lber"	"ireland"	"Ireland_Art_Foot_6_lber"	"Art_Foot_6_lber"
"Ireland_Art_Foot_7_lber_Howitzer"	"ireland"	"Ireland_Art_Foot_7_lber_Howitzer"	"Art_Foot_7_lber_Howitzer"
"Ireland_Art_Horse_6_lber"	"ireland"	"Ireland_Art_Horse_6_lber"	"Art_Horse_6_lber"
"Ireland_Cav_Heavy_Dragoons"	"ireland"	"Ireland_Cav_Heavy_Dragoons"	"Cav_Heavy_Dragoons"
"Ireland_Cav_Light_Light_Dragoons"	"ireland"	"Ireland_Cav_Light_Light_Dragoons"	"Cav_Light_Light_Dragoons"
"Ireland_Gen_Generals_Staff"	"ireland"	"Ireland_Gen_Generals_Staff"	"Gen_Generals_Staff"
"Ireland_Inf_Light_Light_Infantry"	"ireland"	"Ireland_Inf_Light_Light_Infantry"	"Inf_Light_Light_Infantry"
"Ireland_Inf_Line_Line_Infantry"	"ireland"	"Ireland_Inf_Line_Line_Infantry"	"Inf_Line_Line_Infantry"
"Ireland_Inf_Militia_Militia"	"ireland"	"Ireland_Inf_Militia_Militia"	"Inf_Militia_Militia"
"Ireland_Inf_Mob_Armed_Citizenry"	"ireland"	"Ireland_Inf_Mob_Armed_Citizenry"	"Inf_Mob_Armed_Citizenry"
"Austrian_Alliance_Art_Foot_Austrian_12_lber"	"ita_austrian_alliance"	"Austrian_Alliance_Art_Foot_Austrian_12_lber"	"Art_Foot_Austrian_12_lber"
"Austrian_Alliance_Art_Foot_Austrian_6_lber"	"ita_austrian_alliance"	"Austrian_Alliance_Art_Foot_Austrian_6_lber"	"Art_Foot_Austrian_6_lber"
"Austrian_Alliance_Art_Foot_Austrian_7_lber_Howitzer"	"ita_austrian_alliance"	"Austrian_Alliance_Art_Foot_Austrian_7_lber_Howitzer"	"Art_Foot_Austrian_7_lber_Howitzer"
"Austrian_Alliance_Cav_Heavy_Austrian_Cuirassiers"	"ita_austrian_alliance"	"Austrian_Alliance_Cav_Heavy_Austrian_Cuirassiers"	"Cav_Heavy_Austrian_Cuirassiers"
"Austrian_Alliance_Cav_Heavy_Austrian_Dragoons"	"ita_austrian_alliance"	"Austrian_Alliance_Cav_Heavy_Austrian_Dragoons"	"Cav_Heavy_Austrian_Dragoons"
"Austrian_Alliance_Cav_Lancer_Austrian_Ulans"	"ita_austrian_alliance"	"Austrian_Alliance_Cav_Lancer_Austrian_Ulans"	"Cav_Lancer_Austrian_Ulans"
"Austrian_Alliance_Cav_Light_Austrian_Hungarian_Hussars"	"ita_austrian_alliance"	"Austrian_Alliance_Cav_Light_Austrian_Hungarian_Hussars"	"Cav_Light_Austrian_Hungarian_Hussars"
"Austrian_Alliance_Cav_Stand_Austrian_Chevauxlegers"	"ita_austrian_alliance"	"Austrian_Alliance_Cav_Stand_Austrian_Chevauxlegers"	"Cav_Stand_Austrian_Chevauxlegers"
"Austrian_Alliance_Gen_Generals_Staff"	"ita_austrian_alliance"	"Austrian_Alliance_Gen_Generals_Staff"	"Gen_Generals_Staff"
"Austrian_Alliance_Gen_Johann_Beaulieu"	"ita_austrian_alliance"	"Austrian_Alliance_Gen_Johann_Beaulieu"	"Gen_Johann_Beaulieu"
"Austrian_Alliance_Gen_Jozsef_Alvinczi"	"ita_austrian_alliance"	"Austrian_Alliance_Gen_Jozsef_Alvinczi"	"Gen_Jozsef_Alvinczi"
"Austrian_Alliance_Inf_Gren_Austrian_German_Grenadiers"	"ita_austrian_alliance"	"Austrian_Alliance_Inf_Gren_Austrian_German_Grenadiers"	"Inf_Gren_Austrian_German_Grenadiers"
"Austrian_Alliance_Inf_Light_Austrian_Grenzers"	"ita_austrian_alliance"	"Austrian_Alliance_Inf_Light_Austrian_Grenzers"	"Inf_Light_Austrian_Grenzers"
"Austrian_Alliance_Inf_Line_Austrian_German_Fusiliers"	"ita_austrian_alliance"	"Austrian_Alliance_Inf_Line_Austrian_German_Fusiliers"	"Inf_Line_Austrian_German_Fusiliers"
"Austrian_Alliance_Inf_Militia_Austrian_Landwehr"	"ita_austrian_alliance"	"Austrian_Alliance_Inf_Militia_Austrian_Landwehr"	"Inf_Militia_Austrian_Landwehr"
"Austrian_Alliance_Inf_Mob_Armed_Citizenry"	"ita_austrian_alliance"	"Austrian_Alliance_Inf_Mob_Armed_Citizenry"	"Inf_Mob_Armed_Citizenry"
"Austrian_Alliance_Inf_Skirm_Austrian_Jager"	"ita_austrian_alliance"	"Austrian_Alliance_Inf_Skirm_Austrian_Jager"	"Inf_Skirm_Austrian_Jager"
"French_Rep_Ita_Art_Foot_French_12_lber"	"ita_french_republic"	"French_Rep_Ita_Art_Foot_French_12_lber"	"Art_Foot_French_12_lber"
"French_Rep_Ita_Art_Foot_French_6_In_Howitzer"	"ita_french_republic"	"French_Rep_Ita_Art_Foot_French_6_In_Howitzer"	"Art_Foot_French_6_In_Howitzer"
"French_Rep_Ita_Art_Foot_French_6_lber"	"ita_french_republic"	"French_Rep_Ita_Art_Foot_French_6_lber"	"Art_Foot_French_6_lber"
"French_Rep_Ita_Art_Foot_French_8_lber"	"ita_french_republic"	"French_Rep_Ita_Art_Foot_French_8_lber"	"Art_Foot_French_8_lber"
"French_Rep_Ita_Art_Horse_French_6_lber"	"ita_french_republic"	"French_Rep_Ita_Art_Horse_French_6_lber"	"Art_Horse_French_6_lber"
"French_Rep_Ita_Cav_Heavy_French_Dragoons"	"ita_french_republic"	"French_Rep_Ita_Cav_Heavy_French_Dragoons"	"Cav_Heavy_French_Dragoons"
"French_Rep_Ita_Cav_Light_French_Chasseurs_a_Cheval"	"ita_french_republic"	"French_Rep_Ita_Cav_Light_French_Chasseurs_a_Cheval"	"Cav_Light_French_Chasseurs_a_Cheval"
"French_Rep_Ita_Gen_Early_Napoleon"	"ita_french_republic"	"French_Rep_Ita_Gen_Early_Napoleon"	"Gen_Early_Napoleon"
"French_Rep_Ita_Gen_Generals_Staff"	"ita_french_republic"	"French_Rep_Ita_Gen_Generals_Staff"	"Gen_Generals_Staff"
"French_Rep_Ita_Inf_Gren_French_Grenadiers"	"ita_french_republic"	"French_Rep_Ita_Inf_Gren_French_Grenadiers"	"Inf_Gren_French_Grenadiers"
"French_Rep_Ita_Inf_Light_French_Chasseurs"	"ita_french_republic"	"French_Rep_Ita_Inf_Light_French_Chasseurs"	"Inf_Light_French_Chasseurs"
"French_Rep_Ita_Inf_Light_Lombardy-Cisalpine_Legion"	"ita_french_republic"	"French_Rep_Ita_Inf_Light_Lombardy-Cisalpine_Legion"	"Inf_Light_Lombardy-Cisalpine_Legion"
"French_Rep_Ita_Inf_Line_French_Fusiliers"	"ita_french_republic"	"French_Rep_Ita_Inf_Line_French_Fusiliers"	"Inf_Line_French_Fusiliers"
"French_Rep_Ita_Inf_Line_French_Milan_Revolutionary_Infantry"	"ita_french_republic"	"French_Rep_Ita_Inf_Line_French_Milan_Revolutionary_Infantry"	"Inf_Line_French_Milan_Revolutionary_Infantry"
"French_Rep_Ita_Inf_Line_French_Modena_Revolutionary_Infantry"	"ita_french_republic"	"French_Rep_Ita_Inf_Line_French_Modena_Revolutionary_Infantry"	"Inf_Line_French_Modena_Revolutionary_Infantry"
"French_Rep_Ita_Inf_Line_French_Revolutionary_Infantry"	"ita_french_republic"	"French_Rep_Ita_Inf_Line_French_Revolutionary_Infantry"	"Inf_Line_French_Revolutionary_Infantry"
"French_Rep_Ita_Inf_Militia_French_National_Guard"	"ita_french_republic"	"French_Rep_Ita_Inf_Militia_French_National_Guard"	"Inf_Militia_French_National_Guard"
"French_Rep_Ita_Inf_Militia_Militia"	"ita_french_republic"	"French_Rep_Ita_Inf_Militia_Militia"	"Inf_Militia_Militia"
"French_Rep_Ita_Inf_Mob_Armed_Citizenry"	"ita_french_republic"	"French_Rep_Ita_Inf_Mob_Armed_Citizenry"	"Inf_Mob_Armed_Citizenry"
"Genoa_Art_Foot_12_lber"	"ita_genoa"	"Genoa_Art_Foot_12_lber"	"Art_Foot_12_lber"
"Genoa_Art_Foot_6_lber"	"ita_genoa"	"Genoa_Art_Foot_6_lber"	"Art_Foot_6_lber"
"Genoa_Art_Foot_7_lber_Howitzer"	"ita_genoa"	"Genoa_Art_Foot_7_lber_Howitzer"	"Art_Foot_7_lber_Howitzer"
"Genoa_Cav_Heavy_Dragoons"	"ita_genoa"	"Genoa_Cav_Heavy_Dragoons"	"Cav_Heavy_Dragoons"
"Genoa_Gen_Generals_Staff"	"ita_genoa"	"Genoa_Gen_Generals_Staff"	"Gen_Generals_Staff"
"Genoa_Inf_Gren_Grenadiers"	"ita_genoa"	"Genoa_Inf_Gren_Grenadiers"	"Inf_Gren_Grenadiers"
"Genoa_Inf_Line_Line_Infantry"	"ita_genoa"	"Genoa_Inf_Line_Line_Infantry"	"Inf_Line_Line_Infantry"
"Genoa_Inf_Militia_Militia"	"ita_genoa"	"Genoa_Inf_Militia_Militia"	"Inf_Militia_Militia"
"Genoa_Inf_Mob_Armed_Citizenry"	"ita_genoa"	"Genoa_Inf_Mob_Armed_Citizenry"	"Inf_Mob_Armed_Citizenry"
"Lucca_Art_Foot_12_lber"	"ita_lucca"	"Lucca_Art_Foot_12_lber"	"Art_Foot_12_lber"
"Lucca_Art_Foot_6_lber"	"ita_lucca"	"Lucca_Art_Foot_6_lber"	"Art_Foot_6_lber"
"Lucca_Art_Foot_7_lber_Howitzer"	"ita_lucca"	"Lucca_Art_Foot_7_lber_Howitzer"	"Art_Foot_7_lber_Howitzer"
"Lucca_Cav_Heavy_Dragoons"	"ita_lucca"	"Lucca_Cav_Heavy_Dragoons"	"Cav_Heavy_Dragoons"
"Lucca_Gen_Generals_Staff"	"ita_lucca"	"Lucca_Gen_Generals_Staff"	"Gen_Generals_Staff"
"Lucca_Inf_Gren_Grenadiers"	"ita_lucca"	"Lucca_Inf_Gren_Grenadiers"	"Inf_Gren_Grenadiers"
"Lucca_Inf_Line_Line_Infantry"	"ita_lucca"	"Lucca_Inf_Line_Line_Infantry"	"Inf_Line_Line_Infantry"
"Lucca_Inf_Militia_Militia"	"ita_lucca"	"Lucca_Inf_Militia_Militia"	"Inf_Militia_Militia"
"Lucca_Inf_Mob_Armed_Citizenry"	"ita_lucca"	"Lucca_Inf_Mob_Armed_Citizenry"	"Inf_Mob_Armed_Citizenry"
"Milan_Art_Foot_12_lber"	"ita_milan"	"Milan_Art_Foot_12_lber"	"Art_Foot_12_lber"
"Milan_Art_Foot_6_lber"	"ita_milan"	"Milan_Art_Foot_6_lber"	"Art_Foot_6_lber"
"Milan_Art_Foot_7_lber_Howitzer"	"ita_milan"	"Milan_Art_Foot_7_lber_Howitzer"	"Art_Foot_7_lber_Howitzer"
"Milan_Cav_Heavy_Dragoons"	"ita_milan"	"Milan_Cav_Heavy_Dragoons"	"Cav_Heavy_Dragoons"
"Milan_Gen_Generals_Staff"	"ita_milan"	"Milan_Gen_Generals_Staff"	"Gen_Generals_Staff"
"Milan_Inf_Gren_Grenadiers"	"ita_milan"	"Milan_Inf_Gren_Grenadiers"	"Inf_Gren_Grenadiers"
"Milan_Inf_Line_Line_Infantry"	"ita_milan"	"Milan_Inf_Line_Line_Infantry"	"Inf_Line_Line_Infantry"
"Milan_Inf_Militia_Militia"	"ita_milan"	"Milan_Inf_Militia_Militia"	"Inf_Militia_Militia"
"Milan_Inf_Mob_Armed_Citizenry"	"ita_milan"	"Milan_Inf_Mob_Armed_Citizenry"	"Inf_Mob_Armed_Citizenry"
"Modena_Art_Foot_12_lber"	"ita_modena"	"Modena_Art_Foot_12_lber"	"Art_Foot_12_lber"
"Modena_Art_Foot_6_lber"	"ita_modena"	"Modena_Art_Foot_6_lber"	"Art_Foot_6_lber"
"Modena_Art_Foot_7_lber_Howitzer"	"ita_modena"	"Modena_Art_Foot_7_lber_Howitzer"	"Art_Foot_7_lber_Howitzer"
"Modena_Cav_Heavy_Dragoons"	"ita_modena"	"Modena_Cav_Heavy_Dragoons"	"Cav_Heavy_Dragoons"
"Modena_Gen_Generals_Staff"	"ita_modena"	"Modena_Gen_Generals_Staff"	"Gen_Generals_Staff"
"Modena_Inf_Gren_Grenadiers"	"ita_modena"	"Modena_Inf_Gren_Grenadiers"	"Inf_Gren_Grenadiers"
"Modena_Inf_Line_Line_Infantry"	"ita_modena"	"Modena_Inf_Line_Line_Infantry"	"Inf_Line_Line_Infantry"
"Modena_Inf_Militia_Militia"	"ita_modena"	"Modena_Inf_Militia_Militia"	"Inf_Militia_Militia"
"Modena_Inf_Mob_Armed_Citizenry"	"ita_modena"	"Modena_Inf_Mob_Armed_Citizenry"	"Inf_Mob_Armed_Citizenry"
"Papal_States_Art_Foot_12_lber"	"ita_papal_states"	"Papal_States_Art_Foot_12_lber"	"Art_Foot_12_lber"
"Papal_States_Art_Foot_6_lber"	"ita_papal_states"	"Papal_States_Art_Foot_6_lber"	"Art_Foot_6_lber"
"Papal_States_Art_Foot_7_lber_Howitzer"	"ita_papal_states"	"Papal_States_Art_Foot_7_lber_Howitzer"	"Art_Foot_7_lber_Howitzer"
"Papal_States_Cav_Heavy_Dragoons"	"ita_papal_states"	"Papal_States_Cav_Heavy_Dragoons"	"Cav_Heavy_Dragoons"
"Papal_States_Cav_Light_Hussars"	"ita_papal_states"	"Papal_States_Cav_Light_Hussars"	"Cav_Light_Hussars"
"Papal_States_Gen_Generals_Staff"	"ita_papal_states"	"Papal_States_Gen_Generals_Staff"	"Gen_Generals_Staff"
"Papal_States_Inf_Gren_Grenadiers"	"ita_papal_states"	"Papal_States_Inf_Gren_Grenadiers"	"Inf_Gren_Grenadiers"
"Papal_States_Inf_Line_Line_Infantry"	"ita_papal_states"	"Papal_States_Inf_Line_Line_Infantry"	"Inf_Line_Line_Infantry"
"Papal_States_Inf_Militia_Militia"	"ita_papal_states"	"Papal_States_Inf_Militia_Militia"	"Inf_Militia_Militia"
"Papal_States_Inf_Mob_Armed_Citizenry"	"ita_papal_states"	"Papal_States_Inf_Mob_Armed_Citizenry"	"Inf_Mob_Armed_Citizenry"
"Papal_States_Inf_Skirm_Jager"	"ita_papal_states"	"Papal_States_Inf_Skirm_Jager"	"Inf_Skirm_Jager"
"Parma_Art_Foot_12_lber"	"ita_parma"	"Parma_Art_Foot_12_lber"	"Art_Foot_12_lber"
"Parma_Art_Foot_6_lber"	"ita_parma"	"Parma_Art_Foot_6_lber"	"Art_Foot_6_lber"
"Parma_Art_Foot_7_lber_Howitzer"	"ita_parma"	"Parma_Art_Foot_7_lber_Howitzer"	"Art_Foot_7_lber_Howitzer"
"Parma_Cav_Heavy_Dragoons"	"ita_parma"	"Parma_Cav_Heavy_Dragoons"	"Cav_Heavy_Dragoons"
"Parma_Gen_Generals_Staff"	"ita_parma"	"Parma_Gen_Generals_Staff"	"Gen_Generals_Staff"
"Parma_Inf_Gren_Grenadiers"	"ita_parma"	"Parma_Inf_Gren_Grenadiers"	"Inf_Gren_Grenadiers"
"Parma_Inf_Line_Line_Infantry"	"ita_parma"	"Parma_Inf_Line_Line_Infantry"	"Inf_Line_Line_Infantry"
"Parma_Inf_Militia_Militia"	"ita_parma"	"Parma_Inf_Militia_Militia"	"Inf_Militia_Militia"
"Parma_Inf_Mob_Armed_Citizenry"	"ita_parma"	"Parma_Inf_Mob_Armed_Citizenry"	"Inf_Mob_Armed_Citizenry"
"Piedmont_Art_Foot_12_lber"	"ita_piedmont"	"Piedmont_Art_Foot_12_lber"	"Art_Foot_12_lber"
"Piedmont_Art_Foot_6_lber"	"ita_piedmont"	"Piedmont_Art_Foot_6_lber"	"Art_Foot_6_lber"
"Piedmont_Art_Foot_7_lber_Howitzer"	"ita_piedmont"	"Piedmont_Art_Foot_7_lber_Howitzer"	"Art_Foot_7_lber_Howitzer"
"Piedmont_Cav_Heavy_Dragoons"	"ita_piedmont"	"Piedmont_Cav_Heavy_Dragoons"	"Cav_Heavy_Dragoons"
"Piedmont_Cav_Heavy_Life_Guards_of_Horse"	"ita_piedmont"	"Piedmont_Cav_Heavy_Life_Guards_of_Horse"	"Cav_Heavy_Life_Guards_of_Horse"
"Piedmont_Gen_Generals_Staff"	"ita_piedmont"	"Piedmont_Gen_Generals_Staff"	"Gen_Generals_Staff"
"Piedmont_Inf_Elite_Grenadier_Guards"	"ita_piedmont"	"Piedmont_Inf_Elite_Grenadier_Guards"	"Inf_Elite_Grenadier_Guards"
"Piedmont_Inf_Gren_Grenadiers"	"ita_piedmont"	"Piedmont_Inf_Gren_Grenadiers"	"Inf_Gren_Grenadiers"
"Piedmont_Inf_Line_Line_Infantry"	"ita_piedmont"	"Piedmont_Inf_Line_Line_Infantry"	"Inf_Line_Line_Infantry"
"Piedmont_Inf_Militia_Militia"	"ita_piedmont"	"Piedmont_Inf_Militia_Militia"	"Inf_Militia_Militia"
"Piedmont_Inf_Mob_Armed_Citizenry"	"ita_piedmont"	"Piedmont_Inf_Mob_Armed_Citizenry"	"Inf_Mob_Armed_Citizenry"
"Trent_Art_Foot_12_lber"	"ita_trent"	"Trent_Art_Foot_12_lber"	"Art_Foot_12_lber"
"Trent_Art_Foot_6_lber"	"ita_trent"	"Trent_Art_Foot_6_lber"	"Art_Foot_6_lber"
"Trent_Art_Foot_7_lber_Howitzer"	"ita_trent"	"Trent_Art_Foot_7_lber_Howitzer"	"Art_Foot_7_lber_Howitzer"
"Trent_Cav_Heavy_Dragoons"	"ita_trent"	"Trent_Cav_Heavy_Dragoons"	"Cav_Heavy_Dragoons"
"Trent_Gen_Generals_Staff"	"ita_trent"	"Trent_Gen_Generals_Staff"	"Gen_Generals_Staff"
"Trent_Inf_Gren_Grenadiers"	"ita_trent"	"Trent_Inf_Gren_Grenadiers"	"Inf_Gren_Grenadiers"
"Trent_Inf_Line_Line_Infantry"	"ita_trent"	"Trent_Inf_Line_Line_Infantry"	"Inf_Line_Line_Infantry"
"Trent_Inf_Militia_Militia"	"ita_trent"	"Trent_Inf_Militia_Militia"	"Inf_Militia_Militia"
"Trent_Inf_Mob_Armed_Citizenry"	"ita_trent"	"Trent_Inf_Mob_Armed_Citizenry"	"Inf_Mob_Armed_Citizenry"
"Tuscany_Art_Foot_12_lber"	"ita_tuscany"	"Tuscany_Art_Foot_12_lber"	"Art_Foot_12_lber"
"Tuscany_Art_Foot_6_lber"	"ita_tuscany"	"Tuscany_Art_Foot_6_lber"	"Art_Foot_6_lber"
"Tuscany_Art_Foot_7_lber_Howitzer"	"ita_tuscany"	"Tuscany_Art_Foot_7_lber_Howitzer"	"Art_Foot_7_lber_Howitzer"
"Tuscany_Cav_Heavy_Dragoons"	"ita_tuscany"	"Tuscany_Cav_Heavy_Dragoons"	"Cav_Heavy_Dragoons"
"Tuscany_Gen_Generals_Staff"	"ita_tuscany"	"Tuscany_Gen_Generals_Staff"	"Gen_Generals_Staff"
"Tuscany_Inf_Gren_Grenadiers"	"ita_tuscany"	"Tuscany_Inf_Gren_Grenadiers"	"Inf_Gren_Grenadiers"
"Tuscany_Inf_Line_Line_Infantry"	"ita_tuscany"	"Tuscany_Inf_Line_Line_Infantry"	"Inf_Line_Line_Infantry"
"Tuscany_Inf_Militia_Militia"	"ita_tuscany"	"Tuscany_Inf_Militia_Militia"	"Inf_Militia_Militia"
"Tuscany_Inf_Mob_Armed_Citizenry"	"ita_tuscany"	"Tuscany_Inf_Mob_Armed_Citizenry"	"Inf_Mob_Armed_Citizenry"
"Venice_Art_Foot_12_lber"	"ita_venice"	"Venice_Art_Foot_12_lber"	"Art_Foot_12_lber"
"Venice_Art_Foot_6_lber"	"ita_venice"	"Venice_Art_Foot_6_lber"	"Art_Foot_6_lber"
"Venice_Art_Foot_7_lber_Howitzer"	"ita_venice"	"Venice_Art_Foot_7_lber_Howitzer"	"Art_Foot_7_lber_Howitzer"
"Venice_Cav_Heavy_Dragoons"	"ita_venice"	"Venice_Cav_Heavy_Dragoons"	"Cav_Heavy_Dragoons"
"Venice_Gen_Generals_Staff"	"ita_venice"	"Venice_Gen_Generals_Staff"	"Gen_Generals_Staff"
"Venice_Inf_Gren_Grenadiers"	"ita_venice"	"Venice_Inf_Gren_Grenadiers"	"Inf_Gren_Grenadiers"
"Venice_Inf_Line_Line_Infantry"	"ita_venice"	"Venice_Inf_Line_Line_Infantry"	"Inf_Line_Line_Infantry"
"Venice_Inf_Militia_Militia"	"ita_venice"	"Venice_Inf_Militia_Militia"	"Inf_Militia_Militia"
"Venice_Inf_Mob_Armed_Citizenry"	"ita_venice"	"Venice_Inf_Mob_Armed_Citizenry"	"Inf_Mob_Armed_Citizenry"
"Italian_Rebels_Art_Foot_12_lber"	"italian_rebels"	"Italian_Rebels_Art_Foot_12_lber"	"Art_Foot_12_lber"
"Italian_Rebels_Art_Foot_6_lber"	"italian_rebels"	"Italian_Rebels_Art_Foot_6_lber"	"Art_Foot_6_lber"
"Italian_Rebels_Art_Foot_7_lber_Howitzer"	"italian_rebels"	"Italian_Rebels_Art_Foot_7_lber_Howitzer"	"Art_Foot_7_lber_Howitzer"
"Italian_Rebels_Cav_Heavy_Dragoons"	"italian_rebels"	"Italian_Rebels_Cav_Heavy_Dragoons"	"Cav_Heavy_Dragoons"
"Italian_Rebels_Gen_Generals_Staff"	"italian_rebels"	"Italian_Rebels_Gen_Generals_Staff"	"Gen_Generals_Staff"
"Italian_Rebels_Inf_Gren_Grenadiers"	"italian_rebels"	"Italian_Rebels_Inf_Gren_Grenadiers"	"Inf_Gren_Grenadiers"
"Italian_Rebels_Inf_Line_Line_Infantry"	"italian_rebels"	"Italian_Rebels_Inf_Line_Line_Infantry"	"Inf_Line_Line_Infantry"
"Italian_Rebels_Inf_Militia_Militia"	"italian_rebels"	"Italian_Rebels_Inf_Militia_Militia"	"Inf_Militia_Militia"
"Italian_Rebels_Inf_Mob_Armed_Citizenry"	"italian_rebels"	"Italian_Rebels_Inf_Mob_Armed_Citizenry"	"Inf_Mob_Armed_Citizenry"
"Italy_Art_Foot_12_lber"	"italy"	"Italy_Art_Foot_12_lber"	"Art_Foot_12_lber"
"Italy_Art_Foot_6_lber"	"italy"	"Italy_Art_Foot_6_lber"	"Art_Foot_6_lber"
"Italy_Art_Foot_7_lber_Howitzer"	"italy"	"Italy_Art_Foot_7_lber_Howitzer"	"Art_Foot_7_lber_Howitzer"
"Italy_Art_Horse_6_lber"	"italy"	"Italy_Art_Horse_6_lber"	"Art_Horse_6_lber"
"Italy_Cav_Heavy_Dragoons"	"italy"	"Italy_Cav_Heavy_Dragoons"	"Cav_Heavy_Dragoons"
"Italy_Cav_Light_Hussars"	"italy"	"Italy_Cav_Light_Hussars"	"Cav_Light_Hussars"
"Italy_Gen_Generals_Staff"	"italy"	"Italy_Gen_Generals_Staff"	"Gen_Generals_Staff"
"Italy_Inf_Gren_Grenadiers"	"italy"	"Italy_Inf_Gren_Grenadiers"	"Inf_Gren_Grenadiers"
"Italy_Inf_Light_Light_Infantry"	"italy"	"Italy_Inf_Light_Light_Infantry"	"Inf_Light_Light_Infantry"
"Italy_Inf_Line_Line_Infantry"	"italy"	"Italy_Inf_Line_Line_Infantry"	"Inf_Line_Line_Infantry"
"Italy_Inf_Militia_Militia"	"italy"	"Italy_Inf_Militia_Militia"	"Inf_Militia_Militia"
"Italy_Inf_Mob_Armed_Citizenry"	"italy"	"Italy_Inf_Mob_Armed_Citizenry"	"Inf_Mob_Armed_Citizenry"
"Kingdom_Italy_Art_Foot_12_lber"	"italy_kingdom"	"Kingdom_Italy_Art_Foot_12_lber"	"Art_Foot_12_lber"
"Kingdom_Italy_Art_Foot_6_lber"	"italy_kingdom"	"Kingdom_Italy_Art_Foot_6_lber"	"Art_Foot_6_lber"
"Kingdom_Italy_Art_Foot_7_lber_Howitzer"	"italy_kingdom"	"Kingdom_Italy_Art_Foot_7_lber_Howitzer"	"Art_Foot_7_lber_Howitzer"
"Kingdom_Italy_Art_Foot_Italian_Guard_Foot_Artillery"	"italy_kingdom"	"Kingdom_Italy_Art_Foot_Italian_Guard_Foot_Artillery"	"Art_Foot_Italian_Guard_Foot_Artillery"
"Kingdom_Italy_Art_Horse_6_lber"	"italy_kingdom"	"Kingdom_Italy_Art_Horse_6_lber"	"Art_Horse_6_lber"
"Kingdom_Italy_Art_Horse_Italian_Guard_Horse_Artillery"	"italy_kingdom"	"Kingdom_Italy_Art_Horse_Italian_Guard_Horse_Artillery"	"Art_Horse_Italian_Guard_Horse_Artillery"
"Kingdom_Italy_Cav_Heavy_Dragoons"	"italy_kingdom"	"Kingdom_Italy_Cav_Heavy_Dragoons"	"Cav_Heavy_Dragoons"
"Kingdom_Italy_Cav_Heavy_Italian_Guards_of_Honour"	"italy_kingdom"	"Kingdom_Italy_Cav_Heavy_Italian_Guards_of_Honour"	"Cav_Heavy_Italian_Guards_of_Honour"
"Kingdom_Italy_Cav_Light_Italian_Chasseurs_a_Cheval"	"italy_kingdom"	"Kingdom_Italy_Cav_Light_Italian_Chasseurs_a_Cheval"	"Cav_Light_Italian_Chasseurs_a_Cheval"
"Kingdom_Italy_Gen_Generals_Staff"	"italy_kingdom"	"Kingdom_Italy_Gen_Generals_Staff"	"Gen_Generals_Staff"
"Kingdom_Italy_Inf_Elite_Italian_Velite_Grenadiers"	"italy_kingdom"	"Kingdom_Italy_Inf_Elite_Italian_Velite_Grenadiers"	"Inf_Elite_Italian_Velite_Grenadiers"
"Kingdom_Italy_Inf_Gren_Grenadiers"	"italy_kingdom"	"Kingdom_Italy_Inf_Gren_Grenadiers"	"Inf_Gren_Grenadiers"
"Kingdom_Italy_Inf_Light_Light_Infantry"	"italy_kingdom"	"Kingdom_Italy_Inf_Light_Light_Infantry"	"Inf_Light_Light_Infantry"
"Kingdom_Italy_Inf_Line_Line_Infantry"	"italy_kingdom"	"Kingdom_Italy_Inf_Line_Line_Infantry"	"Inf_Line_Line_Infantry"
"Kingdom_Italy_Inf_Militia_Militia"	"italy_kingdom"	"Kingdom_Italy_Inf_Militia_Militia"	"Inf_Militia_Militia"
"Kingdom_Italy_Inf_Mob_Armed_Citizenry"	"italy_kingdom"	"Kingdom_Italy_Inf_Mob_Armed_Citizenry"	"Inf_Mob_Armed_Citizenry"
"Mecklenburg_Art_Foot_12_lber"	"mecklenburg"	"Mecklenburg_Art_Foot_12_lber"	"Art_Foot_12_lber"
"Mecklenburg_Art_Foot_6_lber"	"mecklenburg"	"Mecklenburg_Art_Foot_6_lber"	"Art_Foot_6_lber"
"Mecklenburg_Art_Foot_7_lber_Howitzer"	"mecklenburg"	"Mecklenburg_Art_Foot_7_lber_Howitzer"	"Art_Foot_7_lber_Howitzer"
"Mecklenburg_Art_Horse_6_lber"	"mecklenburg"	"Mecklenburg_Art_Horse_6_lber"	"Art_Horse_6_lber"
"Mecklenburg_Cav_Stand_Chevauxlegers"	"mecklenburg"	"Mecklenburg_Cav_Stand_Chevauxlegers"	"Cav_Stand_Chevauxlegers"
"Mecklenburg_Gen_Generals_Staff"	"mecklenburg"	"Mecklenburg_Gen_Generals_Staff"	"Gen_Generals_Staff"
"Mecklenburg_Inf_Line_Line_Infantry"	"mecklenburg"	"Mecklenburg_Inf_Line_Line_Infantry"	"Inf_Line_Line_Infantry"
"Mecklenburg_Inf_Militia_Militia"	"mecklenburg"	"Mecklenburg_Inf_Militia_Militia"	"Inf_Militia_Militia"
"Mecklenburg_Inf_Mob_Armed_Citizenry"	"mecklenburg"	"Mecklenburg_Inf_Mob_Armed_Citizenry"	"Inf_Mob_Armed_Citizenry"
"Mecklenburg_Inf_Skirm_Jager"	"mecklenburg"	"Mecklenburg_Inf_Skirm_Jager"	"Inf_Skirm_Jager"
"Naples_Art_Foot_12_lber"	"naples"	"Naples_Art_Foot_12_lber"	"Art_Foot_12_lber"
"Naples_Art_Foot_6_lber"	"naples"	"Naples_Art_Foot_6_lber"	"Art_Foot_6_lber"
"Naples_Art_Foot_7_lber_Howitzer"	"naples"	"Naples_Art_Foot_7_lber_Howitzer"	"Art_Foot_7_lber_Howitzer"
"Naples_Art_Horse_6_lber"	"naples"	"Naples_Art_Horse_6_lber"	"Art_Horse_6_lber"
"Naples_Cav_Heavy_Dragoons"	"naples"	"Naples_Cav_Heavy_Dragoons"	"Cav_Heavy_Dragoons"
"Naples_Cav_Light_Hussars"	"naples"	"Naples_Cav_Light_Hussars"	"Cav_Light_Hussars"
"Naples_Gen_Generals_Staff"	"naples"	"Naples_Gen_Generals_Staff"	"Gen_Generals_Staff"
"Naples_Inf_Gren_Grenadiers"	"naples"	"Naples_Inf_Gren_Grenadiers"	"Inf_Gren_Grenadiers"
"Naples_Inf_Light_Light_Infantry"	"naples"	"Naples_Inf_Light_Light_Infantry"	"Inf_Light_Light_Infantry"
"Naples_Inf_Line_Line_Infantry"	"naples"	"Naples_Inf_Line_Line_Infantry"	"Inf_Line_Line_Infantry"
"Naples_Inf_Militia_Militia"	"naples"	"Naples_Inf_Militia_Militia"	"Inf_Militia_Militia"
"Naples_Inf_Mob_Armed_Citizenry"	"naples"	"Naples_Inf_Mob_Armed_Citizenry"	"Inf_Mob_Armed_Citizenry"
"Netherlands_Art_Foot_12_lber"	"netherlands"	"Netherlands_Art_Foot_12_lber"	"Art_Foot_12_lber"
"Netherlands_Art_Foot_6_lber"	"netherlands"	"Netherlands_Art_Foot_6_lber"	"Art_Foot_6_lber"
"Netherlands_Art_Foot_7_lber_Howitzer"	"netherlands"	"Netherlands_Art_Foot_7_lber_Howitzer"	"Art_Foot_7_lber_Howitzer"
"Netherlands_Art_Horse_6_lber"	"netherlands"	"Netherlands_Art_Horse_6_lber"	"Art_Horse_6_lber"
"Netherlands_Cav_Heavy_Dragoons"	"netherlands"	"Netherlands_Cav_Heavy_Dragoons"	"Cav_Heavy_Dragoons"
"Netherlands_Cav_Light_Light_Dragoons"	"netherlands"	"Netherlands_Cav_Light_Light_Dragoons"	"Cav_Light_Light_Dragoons"
"Netherlands_Gen_Generals_Staff"	"netherlands"	"Netherlands_Gen_Generals_Staff"	"Gen_Generals_Staff"
"Netherlands_Inf_Gren_Grenadiers"	"netherlands"	"Netherlands_Inf_Gren_Grenadiers"	"Inf_Gren_Grenadiers"
"Netherlands_Inf_Line_Line_Infantry"	"netherlands"	"Netherlands_Inf_Line_Line_Infantry"	"Inf_Line_Line_Infantry"
"Netherlands_Inf_Militia_Militia"	"netherlands"	"Netherlands_Inf_Militia_Militia"	"Inf_Militia_Militia"
"Netherlands_Inf_Mob_Armed_Citizenry"	"netherlands"	"Netherlands_Inf_Mob_Armed_Citizenry"	"Inf_Mob_Armed_Citizenry"
"Netherlands_Inf_Skirm_Jager"	"netherlands"	"Netherlands_Inf_Skirm_Jager"	"Inf_Skirm_Jager"
"Norway_Art_Foot_12_lber"	"norway"	"Norway_Art_Foot_12_lber"	"Art_Foot_12_lber"
"Norway_Art_Foot_6_lber"	"norway"	"Norway_Art_Foot_6_lber"	"Art_Foot_6_lber"
"Norway_Art_Foot_7_lber_Howitzer"	"norway"	"Norway_Art_Foot_7_lber_Howitzer"	"Art_Foot_7_lber_Howitzer"
"Norway_Art_Horse_6_lber"	"norway"	"Norway_Art_Horse_6_lber"	"Art_Horse_6_lber"
"Norway_Cav_Heavy_Dragoons"	"norway"	"Norway_Cav_Heavy_Dragoons"	"Cav_Heavy_Dragoons"
"Norway_Cav_Light_Light_Dragoons"	"norway"	"Norway_Cav_Light_Light_Dragoons"	"Cav_Light_Light_Dragoons"
"Norway_Gen_Generals_Staff"	"norway"	"Norway_Gen_Generals_Staff"	"Gen_Generals_Staff"
"Norway_Inf_Gren_Grenadiers"	"norway"	"Norway_Inf_Gren_Grenadiers"	"Inf_Gren_Grenadiers"
"Norway_Inf_Line_Line_Infantry"	"norway"	"Norway_Inf_Line_Line_Infantry"	"Inf_Line_Line_Infantry"
"Norway_Inf_Militia_Militia"	"norway"	"Norway_Inf_Militia_Militia"	"Inf_Militia_Militia"
"Norway_Inf_Mob_Armed_Citizenry"	"norway"	"Norway_Inf_Mob_Armed_Citizenry"	"Inf_Mob_Armed_Citizenry"
"Norway_Inf_Skirm_Jager"	"norway"	"Norway_Inf_Skirm_Jager"	"Inf_Skirm_Jager"
"Norway_Inf_Skirm_Norwegian_Ski_Troops"	"norway"	"Norway_Inf_Skirm_Norwegian_Ski_Troops"	"Inf_Skirm_Norwegian_Ski_Troops"
"Oldenburg_Art_Foot_12_lber"	"oldenburg"	"Oldenburg_Art_Foot_12_lber"	"Art_Foot_12_lber"
"Oldenburg_Art_Foot_6_lber"	"oldenburg"	"Oldenburg_Art_Foot_6_lber"	"Art_Foot_6_lber"
"Oldenburg_Art_Foot_7_lber_Howitzer"	"oldenburg"	"Oldenburg_Art_Foot_7_lber_Howitzer"	"Art_Foot_7_lber_Howitzer"
"Oldenburg_Art_Horse_6_lber"	"oldenburg"	"Oldenburg_Art_Horse_6_lber"	"Art_Horse_6_lber"
"Oldenburg_Cav_Stand_Chevauxlegers"	"oldenburg"	"Oldenburg_Cav_Stand_Chevauxlegers"	"Cav_Stand_Chevauxlegers"
"Oldenburg_Gen_Generals_Staff"	"oldenburg"	"Oldenburg_Gen_Generals_Staff"	"Gen_Generals_Staff"
"Oldenburg_Inf_Gren_Grenadiers"	"oldenburg"	"Oldenburg_Inf_Gren_Grenadiers"	"Inf_Gren_Grenadiers"
"Oldenburg_Inf_Line_Line_Infantry"	"oldenburg"	"Oldenburg_Inf_Line_Line_Infantry"	"Inf_Line_Line_Infantry"
"Oldenburg_Inf_Militia_Landwehr"	"oldenburg"	"Oldenburg_Inf_Militia_Landwehr"	"Inf_Militia_Landwehr"
"Oldenburg_Inf_Mob_Armed_Citizenry"	"oldenburg"	"Oldenburg_Inf_Mob_Armed_Citizenry"	"Inf_Mob_Armed_Citizenry"
"Oldenburg_Inf_Skirm_Jager"	"oldenburg"	"Oldenburg_Inf_Skirm_Jager"	"Inf_Skirm_Jager"
"Ottoman_Rebels_Art_Foot_Ottoman_9_lber"	"ottoman_rebels"	"Ottoman_Rebels_Art_Foot_Ottoman_9_lber"	"Art_Foot_Ottoman_9_lber"
"Ottoman_Rebels_Cav_Light_Ottoman_Deli_Horsemen"	"ottoman_rebels"	"Ottoman_Rebels_Cav_Light_Ottoman_Deli_Horsemen"	"Cav_Light_Ottoman_Deli_Horsemen"
"Ottoman_Rebels_Gen_Generals_Bodyguard"	"ottoman_rebels"	"Ottoman_Rebels_Gen_Generals_Bodyguard"	"Gen_Generals_Bodyguard"
"Ottoman_Rebels_Inf_Irreg_Ottoman_Azzars"	"ottoman_rebels"	"Ottoman_Rebels_Inf_Irreg_Ottoman_Azzars"	"Inf_Irreg_Ottoman_Azzars"
"Ottoman_Rebels_Inf_Irreg_Ottoman_Bashi_Bazouks"	"ottoman_rebels"	"Ottoman_Rebels_Inf_Irreg_Ottoman_Bashi_Bazouks"	"Inf_Irreg_Ottoman_Bashi_Bazouks"
"Ottoman_Rebels_Inf_Militia_Ottoman_Peasant_Levy"	"ottoman_rebels"	"Ottoman_Rebels_Inf_Militia_Ottoman_Peasant_Levy"	"Inf_Militia_Ottoman_Peasant_Levy"
"Ottoman_Rebels_Inf_Mob_Armed_Populace"	"ottoman_rebels"	"Ottoman_Rebels_Inf_Mob_Armed_Populace"	"Inf_Mob_Armed_Populace"
"Ottoman_Rebels_Inf_Mob_Armed_Populace_Firelock"	"ottoman_rebels"	"Ottoman_Rebels_Inf_Mob_Armed_Populace_Firelock"	"Inf_Mob_Armed_Populace_Firelock"
"Ottomans_Art_Fix_Ottoman_Bombardment_Mortars"	"ottomans"	"Ottomans_Art_Fix_Ottoman_Bombardment_Mortars"	"Art_Fix_Ottoman_Bombardment_Mortars"
"Ottomans_Art_Foot_Ottoman_18_lber"	"ottomans"	"Ottomans_Art_Foot_Ottoman_18_lber"	"Art_Foot_Ottoman_18_lber"
"Ottomans_Art_Foot_Ottoman_9_lber"	"ottomans"	"Ottomans_Art_Foot_Ottoman_9_lber"	"Art_Foot_Ottoman_9_lber"
"Ottomans_Art_Foot_Ottoman_Howitzers"	"ottomans"	"Ottomans_Art_Foot_Ottoman_Howitzers"	"Art_Foot_Ottoman_Howitzers"
"Ottomans_Cav_Heavy_Ottoman_Silahtar_Guard"	"ottomans"	"Ottomans_Cav_Heavy_Ottoman_Silahtar_Guard"	"Cav_Heavy_Ottoman_Silahtar_Guard"
"Ottomans_Cav_Heavy_Ottoman_Siphai_Cavalry"	"ottomans"	"Ottomans_Cav_Heavy_Ottoman_Siphai_Cavalry"	"Cav_Heavy_Ottoman_Siphai_Cavalry"
"Ottomans_Cav_Light_Ottoman_Deli_Horsemen"	"ottomans"	"Ottomans_Cav_Light_Ottoman_Deli_Horsemen"	"Cav_Light_Ottoman_Deli_Horsemen"
"Ottomans_Cav_Miss_Ottoman_Shaturnal_Camel_Gunners"	"ottomans"	"Ottomans_Cav_Miss_Ottoman_Shaturnal_Camel_Gunners"	"Cav_Miss_Ottoman_Shaturnal_Camel_Gunners"
"Ottomans_Gen_Ahmed_Al-Jazzar"	"ottomans"	"Ottomans_Gen_Ahmed_Al-Jazzar"	"Gen_Ahmed_Al-Jazzar"
"Ottomans_Gen_Generals_Bodyguard"	"ottomans"	"Ottomans_Gen_Generals_Bodyguard"	"Gen_Generals_Bodyguard"
"Ottomans_Gen_Ibrahim_Basha"	"ottomans"	"Ottomans_Gen_Ibrahim_Basha"	"Gen_Ibrahim_Basha"
"Ottomans_Gen_Mehmed_Ali"	"ottomans"	"Ottomans_Gen_Mehmed_Ali"	"Gen_Mehmed_Ali"
"Ottomans_Gen_Murad_Bey"	"ottomans"	"Ottomans_Gen_Murad_Bey"	"Gen_Murad_Bey"
"Ottomans_Inf_Gren_Ottoman_Beylik_Janissary_Grenadiers"	"ottomans"	"Ottomans_Inf_Gren_Ottoman_Beylik_Janissary_Grenadiers"	"Inf_Gren_Ottoman_Beylik_Janissary_Grenadiers"
"Ottomans_Inf_Irreg_Ottoman_Azzars"	"ottomans"	"Ottomans_Inf_Irreg_Ottoman_Azzars"	"Inf_Irreg_Ottoman_Azzars"
"Ottomans_Inf_Irreg_Ottoman_Bashi_Bazouks"	"ottomans"	"Ottomans_Inf_Irreg_Ottoman_Bashi_Bazouks"	"Inf_Irreg_Ottoman_Bashi_Bazouks"
"Ottomans_Inf_Light_Ottoman_Nizam_I_Cedit_Light_Infantry"	"ottomans"	"Ottomans_Inf_Light_Ottoman_Nizam_I_Cedit_Light_Infantry"	"Inf_Light_Ottoman_Nizam_I_Cedit_Light_Infantry"
"Ottomans_Inf_Line_Ottoman_Beylik_Janissary_Musketeers"	"ottomans"	"Ottomans_Inf_Line_Ottoman_Beylik_Janissary_Musketeers"	"Inf_Line_Ottoman_Beylik_Janissary_Musketeers"
"Ottomans_Inf_Line_Ottoman_Nizam_I_Cedit_Infantry"	"ottomans"	"Ottomans_Inf_Line_Ottoman_Nizam_I_Cedit_Infantry"	"Inf_Line_Ottoman_Nizam_I_Cedit_Infantry"
"Ottomans_Inf_Line_Provincial_Ottoman_Nizam_I_Cedit"	"ottomans"	"Ottomans_Inf_Line_Provincial_Ottoman_Nizam_I_Cedit"	"Inf_Line_Provincial_Ottoman_Nizam_I_Cedit"
"Ottomans_Inf_Melee_Ottoman_Cemaat_Janissaries"	"ottomans"	"Ottomans_Inf_Melee_Ottoman_Cemaat_Janissaries"	"Inf_Melee_Ottoman_Cemaat_Janissaries"
"Ottomans_Inf_Militia_Ottoman_Libyan_Bedouin"	"ottomans"	"Ottomans_Inf_Militia_Ottoman_Libyan_Bedouin"	"Inf_Militia_Ottoman_Libyan_Bedouin"
"Ottomans_Inf_Militia_Ottoman_Palestinian_Auxiliaries"	"ottomans"	"Ottomans_Inf_Militia_Ottoman_Palestinian_Auxiliaries"	"Inf_Militia_Ottoman_Palestinian_Auxiliaries"
"Ottomans_Inf_Militia_Ottoman_Peasant_Levy"	"ottomans"	"Ottomans_Inf_Militia_Ottoman_Peasant_Levy"	"Inf_Militia_Ottoman_Peasant_Levy"
"Ottomans_Inf_Mob_Armed_Populace"	"ottomans"	"Ottomans_Inf_Mob_Armed_Populace"	"Inf_Mob_Armed_Populace"
"Ottomans_Inf_Mob_Armed_Populace_Firelock"	"ottomans"	"Ottomans_Inf_Mob_Armed_Populace_Firelock"	"Inf_Mob_Armed_Populace_Firelock"
"Ottomans_Inf_Skirm_Nizam_I_Cedit_Rifles"	"ottomans"	"Ottomans_Inf_Skirm_Nizam_I_Cedit_Rifles"	"Inf_Skirm_Nizam_I_Cedit_Rifles"
"Ottomans_Mounted_Inf_Ottoman_Mounted_Nizam_I_Cedit"	"ottomans"	"Ottomans_Mounted_Inf_Ottoman_Mounted_Nizam_I_Cedit"	"Mounted_Inf_Ottoman_Mounted_Nizam_I_Cedit"
"Savoy_Art_Foot_12_lber"	"piedmont_savoy"	"Savoy_Art_Foot_12_lber"	"Art_Foot_12_lber"
"Savoy_Art_Foot_6_lber"	"piedmont_savoy"	"Savoy_Art_Foot_6_lber"	"Art_Foot_6_lber"
"Savoy_Art_Foot_7_lber_Howitzer"	"piedmont_savoy"	"Savoy_Art_Foot_7_lber_Howitzer"	"Art_Foot_7_lber_Howitzer"
"Savoy_Art_Horse_6_lber"	"piedmont_savoy"	"Savoy_Art_Horse_6_lber"	"Art_Horse_6_lber"
"Savoy_Cav_Heavy_Dragoons"	"piedmont_savoy"	"Savoy_Cav_Heavy_Dragoons"	"Cav_Heavy_Dragoons"
"Savoy_Cav_Heavy_Life_Guards_of_Horse"	"piedmont_savoy"	"Savoy_Cav_Heavy_Life_Guards_of_Horse"	"Cav_Heavy_Life_Guards_of_Horse"
"Savoy_Gen_Generals_Staff"	"piedmont_savoy"	"Savoy_Gen_Generals_Staff"	"Gen_Generals_Staff"
"Savoy_Inf_Elite_Grenadier_Guards"	"piedmont_savoy"	"Savoy_Inf_Elite_Grenadier_Guards"	"Inf_Elite_Grenadier_Guards"
"Savoy_Inf_Line_Line_Infantry"	"piedmont_savoy"	"Savoy_Inf_Line_Line_Infantry"	"Inf_Line_Line_Infantry"
"Savoy_Inf_Militia_Militia"	"piedmont_savoy"	"Savoy_Inf_Militia_Militia"	"Inf_Militia_Militia"
"Savoy_Inf_Mob_Armed_Citizenry"	"piedmont_savoy"	"Savoy_Inf_Mob_Armed_Citizenry"	"Inf_Mob_Armed_Citizenry"
"Poland_Art_Foot_12_lber"	"poland_lithuania"	"Poland_Art_Foot_12_lber"	"Art_Foot_12_lber"
"Poland_Art_Foot_6_lber"	"poland_lithuania"	"Poland_Art_Foot_6_lber"	"Art_Foot_6_lber"
"Poland_Art_Foot_7_lber_Howitzer"	"poland_lithuania"	"Poland_Art_Foot_7_lber_Howitzer"	"Art_Foot_7_lber_Howitzer"
"Poland_Art_Horse_6_lber"	"poland_lithuania"	"Poland_Art_Horse_6_lber"	"Art_Horse_6_lber"
"Poland_Cav_Heavy_Cuirassiers"	"poland_lithuania"	"Poland_Cav_Heavy_Cuirassiers"	"Cav_Heavy_Cuirassiers"
"Poland_Cav_Lancer_Lancers"	"poland_lithuania"	"Poland_Cav_Lancer_Lancers"	"Cav_Lancer_Lancers"
"Poland_Cav_Light_Hussars"	"poland_lithuania"	"Poland_Cav_Light_Hussars"	"Cav_Light_Hussars"
"Poland_Gen_Generals_Staff"	"poland_lithuania"	"Poland_Gen_Generals_Staff"	"Gen_Generals_Staff"
"Poland_Inf_Gren_Grenadiers"	"poland_lithuania"	"Poland_Inf_Gren_Grenadiers"	"Inf_Gren_Grenadiers"
"Poland_Inf_Light_Light_Infantry"	"poland_lithuania"	"Poland_Inf_Light_Light_Infantry"	"Inf_Light_Light_Infantry"
"Poland_Inf_Line_Line_Infantry"	"poland_lithuania"	"Poland_Inf_Line_Line_Infantry"	"Inf_Line_Line_Infantry"
"Poland_Inf_Militia_Militia"	"poland_lithuania"	"Poland_Inf_Militia_Militia"	"Inf_Militia_Militia"
"Poland_Inf_Mob_Armed_Citizenry"	"poland_lithuania"	"Poland_Inf_Mob_Armed_Citizenry"	"Inf_Mob_Armed_Citizenry"
"Portugal_Art_Foot_Portuguese_12_lber"	"portugal"	"Portugal_Art_Foot_Portuguese_12_lber"	"Art_Foot_Portuguese_12_lber"
"Portugal_Art_Foot_Portuguese_6_lber"	"portugal"	"Portugal_Art_Foot_Portuguese_6_lber"	"Art_Foot_Portuguese_6_lber"
"Portugal_Art_Foot_Portuguese_9_lber"	"portugal"	"Portugal_Art_Foot_Portuguese_9_lber"	"Art_Foot_Portuguese_9_lber"
"Portugal_Cav_Stand_Portuguese_Cavalry"	"portugal"	"Portugal_Cav_Stand_Portuguese_Cavalry"	"Cav_Stand_Portuguese_Cavalry"
"Portugal_Gen_Antonio_Henriques"	"portugal"	"Portugal_Gen_Antonio_Henriques"	"Gen_Antonio_Henriques"
"Portugal_Gen_Generals_Staff"	"portugal"	"Portugal_Gen_Generals_Staff"	"Gen_Generals_Staff"
"Portugal_Gen_Gomes_Freire_de_Andrade"	"portugal"	"Portugal_Gen_Gomes_Freire_de_Andrade"	"Gen_Gomes_Freire_de_Andrade"
"Portugal_Gen_Luis_do_Rego_Barreto"	"portugal"	"Portugal_Gen_Luis_do_Rego_Barreto"	"Gen_Luis_do_Rego_Barreto"
"Portugal_Inf_Gren_Portuguese_Grenadiers"	"portugal"	"Portugal_Inf_Gren_Portuguese_Grenadiers"	"Inf_Gren_Portuguese_Grenadiers"
"Portugal_Inf_Light_Portuguese_Cazadores"	"portugal"	"Portugal_Inf_Light_Portuguese_Cazadores"	"Inf_Light_Portuguese_Cazadores"
"Portugal_Inf_Line_Portuguese_Infantry"	"portugal"	"Portugal_Inf_Line_Portuguese_Infantry"	"Inf_Line_Portuguese_Infantry"
"Portugal_Inf_Militia_Portuguese_Militia"	"portugal"	"Portugal_Inf_Militia_Portuguese_Militia"	"Inf_Militia_Portuguese_Militia"
"Portugal_Inf_Mob_Portuguese_Ordenza"	"portugal"	"Portugal_Inf_Mob_Portuguese_Ordenza"	"Inf_Mob_Portuguese_Ordenza"
"Portugal_Inf_Skirm_Portuguese_Tiradores"	"portugal"	"Portugal_Inf_Skirm_Portuguese_Tiradores"	"Inf_Skirm_Portuguese_Tiradores"
"Prussia_Art_Fix_Prussian_Rocket_Troop"	"prussia"	"Prussia_Art_Fix_Prussian_Rocket_Troop"	"Art_Fix_Prussian_Rocket_Troop"
"Prussia_Art_Foot_Prussian_12_lber"	"prussia"	"Prussia_Art_Foot_Prussian_12_lber"	"Art_Foot_Prussian_12_lber"
"Prussia_Art_Foot_Prussian_6_lber"	"prussia"	"Prussia_Art_Foot_Prussian_6_lber"	"Art_Foot_Prussian_6_lber"
"Prussia_Art_Foot_Prussian_7_lber_Howitzer"	"prussia"	"Prussia_Art_Foot_Prussian_7_lber_Howitzer"	"Art_Foot_Prussian_7_lber_Howitzer"
"Prussia_Art_Foot_Prussian_Experimental_Howitzer"	"prussia"	"Prussia_Art_Foot_Prussian_Experimental_Howitzer"	"Art_Foot_Prussian_Experimental_Howitzer"
"Prussia_Art_Horse_Prussian_6_lber"	"prussia"	"Prussia_Art_Horse_Prussian_6_lber"	"Art_Horse_Prussian_6_lber"
"Prussia_Cav_Heavy_Prussian_Cuirassiers"	"prussia"	"Prussia_Cav_Heavy_Prussian_Cuirassiers"	"Cav_Heavy_Prussian_Cuirassiers"
"Prussia_Cav_Heavy_Prussian_Dragoons"	"prussia"	"Prussia_Cav_Heavy_Prussian_Dragoons"	"Cav_Heavy_Prussian_Dragoons"
"Prussia_Cav_Heavy_Republican_Horse_Guards"	"prussia"	"Prussia_Cav_Heavy_Republican_Horse_Guards"	"Cav_Heavy_Republican_Horse_Guards"
"Prussia_Cav_Lancer_Prussian_Brandenburg_Uhlans"	"prussia"	"Prussia_Cav_Lancer_Prussian_Brandenburg_Uhlans"	"Cav_Lancer_Prussian_Brandenburg_Uhlans"
"Prussia_Cav_Lancer_Prussian_Lancers"	"prussia"	"Prussia_Cav_Lancer_Prussian_Lancers"	"Cav_Lancer_Prussian_Lancers"
"Prussia_Cav_Lancer_Prussian_Towarczys"	"prussia"	"Prussia_Cav_Lancer_Prussian_Towarczys"	"Cav_Lancer_Prussian_Towarczys"
"Prussia_Cav_Light_Prussian_Hussars"	"prussia"	"Prussia_Cav_Light_Prussian_Hussars"	"Cav_Light_Prussian_Hussars"
"Prussia_Gen_Count_von_Gneisenau"	"prussia"	"Prussia_Gen_Count_von_Gneisenau"	"Gen_Count_von_Gneisenau"
"Prussia_Gen_Generals_Staff"	"prussia"	"Prussia_Gen_Generals_Staff"	"Gen_Generals_Staff"
"Prussia_Gen_Gerhard_Blucher"	"prussia"	"Prussia_Gen_Gerhard_Blucher"	"Gen_Gerhard_Blucher"
"Prussia_Gen_Gerhard_von_Scharnhorst"	"prussia"	"Prussia_Gen_Gerhard_von_Scharnhorst"	"Gen_Gerhard_von_Scharnhorst"
"Prussia_Inf_Elite_Prussian_Foot_Guards"	"prussia"	"Prussia_Inf_Elite_Prussian_Foot_Guards"	"Inf_Elite_Prussian_Foot_Guards"
"Prussia_Inf_Elite_Prussian_Life_Regiment"	"prussia"	"Prussia_Inf_Elite_Prussian_Life_Regiment"	"Inf_Elite_Prussian_Life_Regiment"
"Prussia_Inf_Elite_Republican_Guards"	"prussia"	"Prussia_Inf_Elite_Republican_Guards"	"Inf_Elite_Republican_Guards"
"Prussia_Inf_Gren_Prussian_East_Prussian_Grenadiers"	"prussia"	"Prussia_Inf_Gren_Prussian_East_Prussian_Grenadiers"	"Inf_Gren_Prussian_East_Prussian_Grenadiers"
"Prussia_Inf_Gren_Prussian_Grenadiers"	"prussia"	"Prussia_Inf_Gren_Prussian_Grenadiers"	"Inf_Gren_Prussian_Grenadiers"
"Prussia_Inf_Light_Prussian_Fusiliers"	"prussia"	"Prussia_Inf_Light_Prussian_Fusiliers"	"Inf_Light_Prussian_Fusiliers"
"Prussia_Inf_Line_Prussian_Musketeers"	"prussia"	"Prussia_Inf_Line_Prussian_Musketeers"	"Inf_Line_Prussian_Musketeers"
"Prussia_Inf_Militia_Prussian_Landwehr"	"prussia"	"Prussia_Inf_Militia_Prussian_Landwehr"	"Inf_Militia_Prussian_Landwehr"
"Prussia_Inf_Mob_Armed_Citizenry"	"prussia"	"Prussia_Inf_Mob_Armed_Citizenry"	"Inf_Mob_Armed_Citizenry"
"Prussia_Inf_Skirm_Prussian_Jager"	"prussia"	"Prussia_Inf_Skirm_Prussian_Jager"	"Inf_Skirm_Prussian_Jager"
"Prussia_Inf_Skirm_Prussian_Silesian_Schuetzen"	"prussia"	"Prussia_Inf_Skirm_Prussian_Silesian_Schuetzen"	"Inf_Skirm_Prussian_Silesian_Schuetzen"
"Prussian_Rebels_Art_Foot_12_lber"	"prussian_rebels"	"Prussian_Rebels_Art_Foot_12_lber"	"Art_Foot_12_lber"
"Prussian_Rebels_Art_Foot_7_lber_Howitzer"	"prussian_rebels"	"Prussian_Rebels_Art_Foot_7_lber_Howitzer"	"Art_Foot_7_lber_Howitzer"
"Prussian_Rebels_Art_Horse_6_lber"	"prussian_rebels"	"Prussian_Rebels_Art_Horse_6_lber"	"Art_Horse_6_lber"
"Prussian_Rebels_Cav_Heavy_Dragoons"	"prussian_rebels"	"Prussian_Rebels_Cav_Heavy_Dragoons"	"Cav_Heavy_Dragoons"
"Prussian_Rebels_Cav_Lancer_Lancers"	"prussian_rebels"	"Prussian_Rebels_Cav_Lancer_Lancers"	"Cav_Lancer_Lancers"
"Prussian_Rebels_Cav_Light_Hussars"	"prussian_rebels"	"Prussian_Rebels_Cav_Light_Hussars"	"Cav_Light_Hussars"
"Prussian_Rebels_Gen_Generals_Staff"	"prussian_rebels"	"Prussian_Rebels_Gen_Generals_Staff"	"Gen_Generals_Staff"
"Prussian_Rebels_Inf_Elite_Life_Regiment"	"prussian_rebels"	"Prussian_Rebels_Inf_Elite_Life_Regiment"	"Inf_Elite_Life_Regiment"
"Prussian_Rebels_Inf_Gren_Grenadiers"	"prussian_rebels"	"Prussian_Rebels_Inf_Gren_Grenadiers"	"Inf_Gren_Grenadiers"
"Prussian_Rebels_Inf_Light_Fusiliers"	"prussian_rebels"	"Prussian_Rebels_Inf_Light_Fusiliers"	"Inf_Light_Fusiliers"
"Prussian_Rebels_Inf_Line_Musketeers"	"prussian_rebels"	"Prussian_Rebels_Inf_Line_Musketeers"	"Inf_Line_Musketeers"
"Prussian_Rebels_Inf_Militia_Landwehr"	"prussian_rebels"	"Prussian_Rebels_Inf_Militia_Landwehr"	"Inf_Militia_Landwehr"
"Prussian_Rebels_Inf_Mob_Armed_Citizenry"	"prussian_rebels"	"Prussian_Rebels_Inf_Mob_Armed_Citizenry"	"Inf_Mob_Armed_Citizenry"
"Prussian_Rebels_Inf_Skirm_Jager"	"prussian_rebels"	"Prussian_Rebels_Inf_Skirm_Jager"	"Inf_Skirm_Jager"
"Romania_Art_Foot_12_lber"	"romania"	"Romania_Art_Foot_12_lber"	"Art_Foot_12_lber"
"Romania_Art_Foot_6_lber"	"romania"	"Romania_Art_Foot_6_lber"	"Art_Foot_6_lber"
"Romania_Art_Foot_7_lber_Howitzer"	"romania"	"Romania_Art_Foot_7_lber_Howitzer"	"Art_Foot_7_lber_Howitzer"
"Romania_Art_Horse_6_lber"	"romania"	"Romania_Art_Horse_6_lber"	"Art_Horse_6_lber"
"Romania_Cav_Heavy_Dragoons"	"romania"	"Romania_Cav_Heavy_Dragoons"	"Cav_Heavy_Dragoons"
"Romania_Cav_Light_Hussars"	"romania"	"Romania_Cav_Light_Hussars"	"Cav_Light_Hussars"
"Romania_Gen_Generals_Staff"	"romania"	"Romania_Gen_Generals_Staff"	"Gen_Generals_Staff"
"Romania_Inf_Gren_Grenadiers"	"romania"	"Romania_Inf_Gren_Grenadiers"	"Inf_Gren_Grenadiers"
"Romania_Inf_Line_Line_Infantry"	"romania"	"Romania_Inf_Line_Line_Infantry"	"Inf_Line_Line_Infantry"
"Romania_Inf_Militia_Militia"	"romania"	"Romania_Inf_Militia_Militia"	"Inf_Militia_Militia"
"Romania_Inf_Mob_Armed_Citizenry"	"romania"	"Romania_Inf_Mob_Armed_Citizenry"	"Inf_Mob_Armed_Citizenry"
"Romania_Inf_Skirm_Jager"	"romania"	"Romania_Inf_Skirm_Jager"	"Inf_Skirm_Jager"
"Russia_Art_Fix_Russian_Rocket_Troop"	"russia"	"Russia_Art_Fix_Russian_Rocket_Troop"	"Art_Fix_Russian_Rocket_Troop"
"Russia_Art_Foot_Russian_10_lber_Unicorn"	"russia"	"Russia_Art_Foot_Russian_10_lber_Unicorn"	"Art_Foot_Russian_10_lber_Unicorn"
"Russia_Art_Foot_Russian_12_lber"	"russia"	"Russia_Art_Foot_Russian_12_lber"	"Art_Foot_Russian_12_lber"
"Russia_Art_Foot_Russian_20_lber_Unicorn"	"russia"	"Russia_Art_Foot_Russian_20_lber_Unicorn"	"Art_Foot_Russian_20_lber_Unicorn"
"Russia_Art_Foot_Russian_6_lber"	"russia"	"Russia_Art_Foot_Russian_6_lber"	"Art_Foot_Russian_6_lber"
"Russia_Art_Foot_Russian_Experimental_Howitzer"	"russia"	"Russia_Art_Foot_Russian_Experimental_Howitzer"	"Art_Foot_Russian_Experimental_Howitzer"
"Russia_Art_Horse_Russian_6_lber"	"russia"	"Russia_Art_Horse_Russian_6_lber"	"Art_Horse_Russian_6_lber"
"Russia_Cav_Heavy_Republican_Horse_Guards"	"russia"	"Russia_Cav_Heavy_Republican_Horse_Guards"	"Cav_Heavy_Republican_Horse_Guards"
"Russia_Cav_Heavy_Russian_Chevalier_Garde"	"russia"	"Russia_Cav_Heavy_Russian_Chevalier_Garde"	"Cav_Heavy_Russian_Chevalier_Garde"
"Russia_Cav_Heavy_Russian_Cuirassiers"	"russia"	"Russia_Cav_Heavy_Russian_Cuirassiers"	"Cav_Heavy_Russian_Cuirassiers"
"Russia_Cav_Heavy_Russian_Dragoons"	"russia"	"Russia_Cav_Heavy_Russian_Dragoons"	"Cav_Heavy_Russian_Dragoons"
"Russia_Cav_Heavy_Russian_Lifeguard_Horse"	"russia"	"Russia_Cav_Heavy_Russian_Lifeguard_Horse"	"Cav_Heavy_Russian_Lifeguard_Horse"
"Russia_Cav_Lancer_Russian_Cossack_Cavalry"	"russia"	"Russia_Cav_Lancer_Russian_Cossack_Cavalry"	"Cav_Lancer_Russian_Cossack_Cavalry"
"Russia_Cav_Lancer_Russian_Ulans"	"russia"	"Russia_Cav_Lancer_Russian_Ulans"	"Cav_Lancer_Russian_Ulans"
"Russia_Cav_Light_Russian_Hussars"	"russia"	"Russia_Cav_Light_Russian_Hussars"	"Cav_Light_Russian_Hussars"
"Russia_Cav_Light_Russian_Pavlograd_Hussars"	"russia"	"Russia_Cav_Light_Russian_Pavlograd_Hussars"	"Cav_Light_Russian_Pavlograd_Hussars"
"Russia_Gen_Count_von_Bennigsen"	"russia"	"Russia_Gen_Count_von_Bennigsen"	"Gen_Count_von_Bennigsen"
"Russia_Gen_Generals_Staff"	"russia"	"Russia_Gen_Generals_Staff"	"Gen_Generals_Staff"
"Russia_Gen_Mikhail_Kutuzov"	"russia"	"Russia_Gen_Mikhail_Kutuzov"	"Gen_Mikhail_Kutuzov"
"Russia_Gen_Prince_de_Tolly"	"russia"	"Russia_Gen_Prince_de_Tolly"	"Gen_Prince_de_Tolly"
"Russia_Gen_Tsar_Alexander"	"russia"	"Russia_Gen_Tsar_Alexander"	"Gen_Tsar_Alexander"
"Russia_Inf_Elite_Republican_Guards"	"russia"	"Russia_Inf_Elite_Republican_Guards"	"Inf_Elite_Republican_Guards"
"Russia_Inf_Elite_Russian_Lifeguard_Foot"	"russia"	"Russia_Inf_Elite_Russian_Lifeguard_Foot"	"Inf_Elite_Russian_Lifeguard_Foot"
"Russia_Inf_Gren_Russian_Grenadiers"	"russia"	"Russia_Inf_Gren_Russian_Grenadiers"	"Inf_Gren_Russian_Grenadiers"
"Russia_Inf_Gren_Russian_Pavlovsk_Grenadiers"	"russia"	"Russia_Inf_Gren_Russian_Pavlovsk_Grenadiers"	"Inf_Gren_Russian_Pavlovsk_Grenadiers"
"Russia_Inf_Light_Russian_17th_Jager"	"russia"	"Russia_Inf_Light_Russian_17th_Jager"	"Inf_Light_Russian_17th_Jager"
"Russia_Inf_Light_Russian_Jager"	"russia"	"Russia_Inf_Light_Russian_Jager"	"Inf_Light_Russian_Jager"
"Russia_Inf_Line_Russian_Moscow_Musketeers"	"russia"	"Russia_Inf_Line_Russian_Moscow_Musketeers"	"Inf_Line_Russian_Moscow_Musketeers"
"Russia_Inf_Line_Russian_Musketeers"	"russia"	"Russia_Inf_Line_Russian_Musketeers"	"Inf_Line_Russian_Musketeers"
"Russia_Inf_Militia_Russian_Opelchenie"	"russia"	"Russia_Inf_Militia_Russian_Opelchenie"	"Inf_Militia_Russian_Opelchenie"
"Russia_Inf_Mob_Armed_Citizenry"	"russia"	"Russia_Inf_Mob_Armed_Citizenry"	"Inf_Mob_Armed_Citizenry"
"Russia_Mounted_Inf_Russian_Mounted_Rifles"	"russia"	"Russia_Mounted_Inf_Russian_Mounted_Rifles"	"Mounted_Inf_Russian_Mounted_Rifles"
"Sardinia_Art_Foot_12_lber"	"sardinia"	"Sardinia_Art_Foot_12_lber"	"Art_Foot_12_lber"
"Sardinia_Art_Foot_6_lber"	"sardinia"	"Sardinia_Art_Foot_6_lber"	"Art_Foot_6_lber"
"Sardinia_Art_Foot_7_lber_Howitzer"	"sardinia"	"Sardinia_Art_Foot_7_lber_Howitzer"	"Art_Foot_7_lber_Howitzer"
"Sardinia_Art_Horse_6_lber"	"sardinia"	"Sardinia_Art_Horse_6_lber"	"Art_Horse_6_lber"
"Sardinia_Cav_Heavy_Dragoons"	"sardinia"	"Sardinia_Cav_Heavy_Dragoons"	"Cav_Heavy_Dragoons"
"Sardinia_Cav_Light_Hussars"	"sardinia"	"Sardinia_Cav_Light_Hussars"	"Cav_Light_Hussars"
"Sardinia_Gen_Generals_Staff"	"sardinia"	"Sardinia_Gen_Generals_Staff"	"Gen_Generals_Staff"
"Sardinia_Inf_Gren_Grenadiers"	"sardinia"	"Sardinia_Inf_Gren_Grenadiers"	"Inf_Gren_Grenadiers"
"Sardinia_Inf_Line_Line_Infantry"	"sardinia"	"Sardinia_Inf_Line_Line_Infantry"	"Inf_Line_Line_Infantry"
"Sardinia_Inf_Militia_Militia"	"sardinia"	"Sardinia_Inf_Militia_Militia"	"Inf_Militia_Militia"
"Sardinia_Inf_Mob_Armed_Citizenry"	"sardinia"	"Sardinia_Inf_Mob_Armed_Citizenry"	"Inf_Mob_Armed_Citizenry"
"Saxony_Art_Foot_6_lber"	"saxony"	"Saxony_Art_Foot_6_lber"	"Art_Foot_6_lber"
"Saxony_Art_Foot_7_lber_Howitzer"	"saxony"	"Saxony_Art_Foot_7_lber_Howitzer"	"Art_Foot_7_lber_Howitzer"
"Saxony_Art_Horse_6_lber"	"saxony"	"Saxony_Art_Horse_6_lber"	"Art_Horse_6_lber"
"Saxony_Cav_Heavy_Cuirassiers"	"saxony"	"Saxony_Cav_Heavy_Cuirassiers"	"Cav_Heavy_Cuirassiers"
"Saxony_Cav_Heavy_Garde_du_Corp"	"saxony"	"Saxony_Cav_Heavy_Garde_du_Corp"	"Cav_Heavy_Garde_du_Corp"
"Saxony_Cav_Light_Hussars"	"saxony"	"Saxony_Cav_Light_Hussars"	"Cav_Light_Hussars"
"Saxony_Cav_Stand_Chevauxlegers"	"saxony"	"Saxony_Cav_Stand_Chevauxlegers"	"Cav_Stand_Chevauxlegers"
"Saxony_Gen_Generals_Staff"	"saxony"	"Saxony_Gen_Generals_Staff"	"Gen_Generals_Staff"
"Saxony_Inf_Gren_Grenadiers"	"saxony"	"Saxony_Inf_Gren_Grenadiers"	"Inf_Gren_Grenadiers"
"Saxony_Inf_Line_Musketeers"	"saxony"	"Saxony_Inf_Line_Musketeers"	"Inf_Line_Musketeers"
"Saxony_Inf_Militia_Landwehr"	"saxony"	"Saxony_Inf_Militia_Landwehr"	"Inf_Militia_Landwehr"
"Saxony_Inf_Mob_Armed_Citizenry"	"saxony"	"Saxony_Inf_Mob_Armed_Citizenry"	"Inf_Mob_Armed_Citizenry"
"Scotland_Art_Foot_12_lber"	"scotland"	"Scotland_Art_Foot_12_lber"	"Art_Foot_12_lber"
"Scotland_Art_Foot_6_lber"	"scotland"	"Scotland_Art_Foot_6_lber"	"Art_Foot_6_lber"
"Scotland_Art_Foot_7_lber_Howitzer"	"scotland"	"Scotland_Art_Foot_7_lber_Howitzer"	"Art_Foot_7_lber_Howitzer"
"Scotland_Art_Horse_6_lber"	"scotland"	"Scotland_Art_Horse_6_lber"	"Art_Horse_6_lber"
"Scotland_Cav_Heavy_Dragoons"	"scotland"	"Scotland_Cav_Heavy_Dragoons"	"Cav_Heavy_Dragoons"
"Scotland_Cav_Light_Light_Dragoons"	"scotland"	"Scotland_Cav_Light_Light_Dragoons"	"Cav_Light_Light_Dragoons"
"Scotland_Gen_Generals_Staff"	"scotland"	"Scotland_Gen_Generals_Staff"	"Gen_Generals_Staff"
"Scotland_Inf_Light_Light_Infantry"	"scotland"	"Scotland_Inf_Light_Light_Infantry"	"Inf_Light_Light_Infantry"
"Scotland_Inf_Line_British_Highland_Foot"	"scotland"	"Scotland_Inf_Line_British_Highland_Foot"	"Inf_Line_British_Highland_Foot"
"Scotland_Inf_Militia_Militia"	"scotland"	"Scotland_Inf_Militia_Militia"	"Inf_Militia_Militia"
"Scotland_Inf_Mob_Armed_Citizenry"	"scotland"	"Scotland_Inf_Mob_Armed_Citizenry"	"Inf_Mob_Armed_Citizenry"
"Sicily_Art_Foot_12_lber"	"sicily"	"Sicily_Art_Foot_12_lber"	"Art_Foot_12_lber"
"Sicily_Art_Foot_6_lber"	"sicily"	"Sicily_Art_Foot_6_lber"	"Art_Foot_6_lber"
"Sicily_Art_Foot_7_lber_Howitzer"	"sicily"	"Sicily_Art_Foot_7_lber_Howitzer"	"Art_Foot_7_lber_Howitzer"
"Sicily_Art_Horse_6_lber"	"sicily"	"Sicily_Art_Horse_6_lber"	"Art_Horse_6_lber"
"Sicily_Cav_Heavy_Dragoons"	"sicily"	"Sicily_Cav_Heavy_Dragoons"	"Cav_Heavy_Dragoons"
"Sicily_Cav_Light_Hussars"	"sicily"	"Sicily_Cav_Light_Hussars"	"Cav_Light_Hussars"
"Sicily_Gen_Generals_Staff"	"sicily"	"Sicily_Gen_Generals_Staff"	"Gen_Generals_Staff"
"Sicily_Inf_Gren_Grenadiers"	"sicily"	"Sicily_Inf_Gren_Grenadiers"	"Inf_Gren_Grenadiers"
"Sicily_Inf_Light_Light_Infantry"	"sicily"	"Sicily_Inf_Light_Light_Infantry"	"Inf_Light_Light_Infantry"
"Sicily_Inf_Line_Line_Infantry"	"sicily"	"Sicily_Inf_Line_Line_Infantry"	"Inf_Line_Line_Infantry"
"Sicily_Inf_Militia_Militia"	"sicily"	"Sicily_Inf_Militia_Militia"	"Inf_Militia_Militia"
"Sicily_Inf_Mob_Armed_Citizenry"	"sicily"	"Sicily_Inf_Mob_Armed_Citizenry"	"Inf_Mob_Armed_Citizenry"
"Slavic_Rebels_Art_Foot_12_lber"	"slavic_rebels"	"Slavic_Rebels_Art_Foot_12_lber"	"Art_Foot_12_lber"
"Slavic_Rebels_Art_Foot_7_lber_Howitzer"	"slavic_rebels"	"Slavic_Rebels_Art_Foot_7_lber_Howitzer"	"Art_Foot_7_lber_Howitzer"
"Slavic_Rebels_Art_Horse_6_lber"	"slavic_rebels"	"Slavic_Rebels_Art_Horse_6_lber"	"Art_Horse_6_lber"
"Slavic_Rebels_Cav_Heavy_Dragoons"	"slavic_rebels"	"Slavic_Rebels_Cav_Heavy_Dragoons"	"Cav_Heavy_Dragoons"
"Slavic_Rebels_Cav_Lancer_Russian_Cossack_Cavalry"	"slavic_rebels"	"Slavic_Rebels_Cav_Lancer_Russian_Cossack_Cavalry"	"Cav_Lancer_Russian_Cossack_Cavalry"
"Slavic_Rebels_Cav_Light_Hussars"	"slavic_rebels"	"Slavic_Rebels_Cav_Light_Hussars"	"Cav_Light_Hussars"
"Slavic_Rebels_Gen_Generals_Staff"	"slavic_rebels"	"Slavic_Rebels_Gen_Generals_Staff"	"Gen_Generals_Staff"
"Slavic_Rebels_Inf_Gren_Grenadiers"	"slavic_rebels"	"Slavic_Rebels_Inf_Gren_Grenadiers"	"Inf_Gren_Grenadiers"
"Slavic_Rebels_Inf_Line_Musketeers"	"slavic_rebels"	"Slavic_Rebels_Inf_Line_Musketeers"	"Inf_Line_Musketeers"
"Slavic_Rebels_Inf_Militia_Militia"	"slavic_rebels"	"Slavic_Rebels_Inf_Militia_Militia"	"Inf_Militia_Militia"
"Slavic_Rebels_Inf_Mob_Armed_Citizenry"	"slavic_rebels"	"Slavic_Rebels_Inf_Mob_Armed_Citizenry"	"Inf_Mob_Armed_Citizenry"
"Slavic_Rebels_Inf_Skirm_Jager"	"slavic_rebels"	"Slavic_Rebels_Inf_Skirm_Jager"	"Inf_Skirm_Jager"
"Britain_Spa_Art_Foot_British_5_In_Howitzer"	"spa_britain"	"Britain_Spa_Art_Foot_British_5_In_Howitzer"	"Art_Foot_British_5_In_Howitzer"
"Britain_Spa_Art_Foot_British_6_lber"	"spa_britain"	"Britain_Spa_Art_Foot_British_6_lber"	"Art_Foot_British_6_lber"
"Britain_Spa_Art_Foot_British_9_lber"	"spa_britain"	"Britain_Spa_Art_Foot_British_9_lber"	"Art_Foot_British_9_lber"
"Britain_Spa_Art_Horse_British_6_lber"	"spa_britain"	"Britain_Spa_Art_Horse_British_6_lber"	"Art_Horse_British_6_lber"
"Britain_Spa_Cav_Heavy_British_Dragoon_Guards"	"spa_britain"	"Britain_Spa_Cav_Heavy_British_Dragoon_Guards"	"Cav_Heavy_British_Dragoon_Guards"
"Britain_Spa_Cav_Heavy_British_Dragoons"	"spa_britain"	"Britain_Spa_Cav_Heavy_British_Dragoons"	"Cav_Heavy_British_Dragoons"
"Britain_Spa_Cav_Heavy_British_KGL_Dragoons"	"spa_britain"	"Britain_Spa_Cav_Heavy_British_KGL_Dragoons"	"Cav_Heavy_British_KGL_Dragoons"
"Britain_Spa_Cav_Light_British_KGL_Light_Dragoons"	"spa_britain"	"Britain_Spa_Cav_Light_British_KGL_Light_Dragoons"	"Cav_Light_British_KGL_Light_Dragoons"
"Britain_Spa_Cav_Light_British_Light_Dragoons"	"spa_britain"	"Britain_Spa_Cav_Light_British_Light_Dragoons"	"Cav_Light_British_Light_Dragoons"
"Britain_Spa_Gen_Duke_of_Wellington"	"spa_britain"	"Britain_Spa_Gen_Duke_of_Wellington"	"Gen_Duke_of_Wellington"
"Britain_Spa_Gen_Generals_Staff"	"spa_britain"	"Britain_Spa_Gen_Generals_Staff"	"Gen_Generals_Staff"
"Britain_Spa_Inf_Elite_British_Black_Watch"	"spa_britain"	"Britain_Spa_Inf_Elite_British_Black_Watch"	"Inf_Elite_British_Black_Watch"
"Britain_Spa_Inf_Elite_British_Foot_Guards"	"spa_britain"	"Britain_Spa_Inf_Elite_British_Foot_Guards"	"Inf_Elite_British_Foot_Guards"
"Britain_Spa_Inf_Light_British_KGL_Light_Foot"	"spa_britain"	"Britain_Spa_Inf_Light_British_KGL_Light_Foot"	"Inf_Light_British_KGL_Light_Foot"
"Britain_Spa_Inf_Light_British_Light_Foot"	"spa_britain"	"Britain_Spa_Inf_Light_British_Light_Foot"	"Inf_Light_British_Light_Foot"
"Britain_Spa_Inf_Line_British_Foot"	"spa_britain"	"Britain_Spa_Inf_Line_British_Foot"	"Inf_Line_British_Foot"
"Britain_Spa_Inf_Line_British_Highland_Foot"	"spa_britain"	"Britain_Spa_Inf_Line_British_Highland_Foot"	"Inf_Line_British_Highland_Foot"
"Britain_Spa_Inf_Line_British_KGL_Foot"	"spa_britain"	"Britain_Spa_Inf_Line_British_KGL_Foot"	"Inf_Line_British_KGL_Foot"
"Britain_Spa_Inf_Militia_Militia"	"spa_britain"	"Britain_Spa_Inf_Militia_Militia"	"Inf_Militia_Militia"
"Britain_Spa_Inf_Mob_Armed_Citizenry"	"spa_britain"	"Spain_Spa_Inf_Mob_Armed_Citizenry"	"Inf_Mob_Armed_Citizenry"
"Britain_Spa_Inf_Skirm_British_Rifles"	"spa_britain"	"Britain_Spa_Inf_Skirm_British_Rifles"	"Inf_Skirm_British_95th"
"France_Spa_Art_Foot_French_12_lber"	"spa_france"	"France_Spa_Art_Foot_French_12_lber"	"Art_Foot_French_12_lber"
"France_Spa_Art_Foot_French_6_In_Howitzer"	"spa_france"	"France_Spa_Art_Foot_French_6_In_Howitzer"	"Art_Foot_French_6_In_Howitzer"
"France_Spa_Art_Foot_French_6_lber"	"spa_france"	"France_Spa_Art_Foot_French_6_lber"	"Art_Foot_French_6_lber"
"France_Spa_Art_Foot_French_8_lber"	"spa_france"	"France_Spa_Art_Foot_French_8_lber"	"Art_Foot_French_8_lber"
"France_Spa_Art_Horse_French_6_lber"	"spa_france"	"France_Spa_Art_Horse_French_6_lber"	"Art_Horse_French_6_lber"
"France_Spa_Cav_Heavy_French_Cuirassiers"	"spa_france"	"France_Spa_Cav_Heavy_French_Cuirassiers"	"Cav_Heavy_French_Cuirassiers"
"France_Spa_Cav_Heavy_French_Dragoons"	"spa_france"	"France_Spa_Cav_Heavy_French_Dragoons"	"Cav_Heavy_French_Dragoons"
"France_Spa_Cav_Light_French_Chasseurs_a_Cheval"	"spa_france"	"France_Spa_Cav_Light_French_Chasseurs_a_Cheval"	"Cav_Light_French_Chasseurs_a_Cheval"
"France_Spa_Gen_Generals_Staff"	"spa_france"	"France_Spa_Gen_Generals_Staff"	"Gen_Generals_Staff"
"France_Spa_Inf_Gren_French_Grenadiers"	"spa_france"	"France_Spa_Inf_Gren_French_Grenadiers"	"Inf_Gren_French_Grenadiers"
"France_Spa_Inf_Light_French_Chasseurs"	"spa_france"	"France_Spa_Inf_Light_French_Chasseurs"	"Inf_Light_French_Chasseurs"
"Britain_Spa_Art_Foot_British_Portuguese_6_lber_Auxiliary"	"spa_britain"	"Portugal_Spa_Art_Foot_Portuguese_6_lber"	"Art_Foot_British_Portuguese_6_lber_Auxiliary"
"Britain_Spa_Cav_Stand_British_Portuguese_Cavalry"	"spa_britain"	"Portugal_Spa_Cav_Stand_Portuguese_Cavalry"	"Cav_Stand_British_Portuguese_Cavalry_Auxiliary"
"France_Spa_Inf_Line_French_Fusiliers"	"spa_france"	"France_Spa_Inf_Line_French_Fusiliers"	"Inf_Line_French_Fusiliers"
"France_Spa_Inf_Line_Polish_Legion"	"spa_france"	"France_Spa_Inf_Line_Polish_Legion"	"Inf_Line_Polish_Legion"
"France_Spa_Inf_Line_Swiss_Foot"	"spa_france"	"France_Spa_Inf_Line_Swiss_Foot"	"Inf_Line_Swiss_Foot"
"France_Spa_Inf_Militia_Militia"	"spa_france"	"France_Spa_Inf_Militia_Militia"	"Inf_Militia_Militia"
"France_Spa_Inf_Mob_Armed_Citizenry"	"spa_france"	"France_Spa_Inf_Mob_Armed_Citizenry"	"Inf_Mob_Armed_Citizenry"
"France_Spa_Inf_Skirm_French_Voltiguers"	"spa_france"	"France_Spa_Inf_Skirm_French_Voltiguers"	"Inf_Skirm_French_Voltiguers"
"Portugal_Spa_Art_Foot_Portuguese_12_lber"	"spa_portugal"	"Portugal_Spa_Art_Foot_Portuguese_12_lber"	"Art_Foot_Portuguese_12_lber"
"Portugal_Spa_Art_Foot_Portuguese_6_lber"	"spa_portugal"	"Portugal_Spa_Art_Foot_Portuguese_6_lber"	"Art_Foot_Portuguese_6_lber"
"Portugal_Spa_Art_Foot_Portuguese_9_lber"	"spa_portugal"	"Portugal_Spa_Art_Foot_Portuguese_9_lber"	"Art_Foot_Portuguese_9_lber"
"Portugal_Spa_Cav_Stand_Portuguese_Cavalry"	"spa_portugal"	"Portugal_Spa_Cav_Stand_Portuguese_Cavalry"	"Cav_Stand_Portuguese_Cavalry"
"Portugal_Spa_Gen_Generals_Staff"	"spa_portugal"	"Portugal_Spa_Gen_Generals_Staff"	"Gen_Generals_Staff"
"Portugal_Spa_Inf_Gren_Portuguese_Grenadiers"	"spa_portugal"	"Portugal_Spa_Inf_Gren_Portuguese_Grenadiers"	"Inf_Gren_Portuguese_Grenadiers"
"Portugal_Spa_Inf_Light_Portuguese_Cazadores"	"spa_portugal"	"Portugal_Spa_Inf_Light_Portuguese_Cazadores"	"Inf_Light_Portuguese_Cazadores"
"Portugal_Spa_Inf_Line_Portuguese_Infantry"	"spa_portugal"	"Portugal_Spa_Inf_Line_Portuguese_Infantry"	"Inf_Line_Portuguese_Infantry"
"Portugal_Spa_Inf_Militia_Portuguese_Militia"	"spa_portugal"	"Portugal_Spa_Inf_Militia_Portuguese_Militia"	"Inf_Militia_Portuguese_Militia"
"Portugal_Spa_Inf_Mob_Portuguese_Ordenza"	"spa_portugal"	"Portugal_Spa_Inf_Mob_Portuguese_Ordenza"	"Inf_Mob_Portuguese_Ordenza"
"Portugal_Spa_Inf_Skirm_Portuguese_Tiradores"	"spa_portugal"	"Portugal_Spa_Inf_Skirm_Portuguese_Tiradores"	"Inf_Skirm_Portuguese_Tiradores"
"Spain_Spa_Art_Foot_Spanish_12_lber"	"spa_spain"	"Spain_Spa_Art_Foot_Spanish_12_lber"	"Art_Foot_Spanish_12_lber"
"Spain_Spa_Art_Foot_Spanish_9_lber"	"spa_spain"	"Spain_Spa_Art_Foot_Spanish_9_lber"	"Art_Foot_Spanish_9_lber"
"Spain_Spa_Cav_Heavy_Spanish_Dragoons"	"spa_spain"	"Spain_Spa_Cav_Heavy_Spanish_Dragoons"	"Cav_Heavy_Spanish_Dragoons"
"Spain_Spa_Cav_Light_Spanish_Hussars"	"spa_spain"	"Spain_Spa_Cav_Light_Spanish_Hussars"	"Cav_Light_Spanish_Hussars"
"Spain_Spa_Gen_Generals_Staff"	"spa_spain"	"Spain_Spa_Gen_Generals_Staff"	"Gen_Generals_Staff"
"Spain_Spa_Inf_Light_Spanish_Light_Infantry"	"spa_spain"	"Spain_Spa_Inf_Light_Spanish_Light_Infantry"	"Inf_Light_Spanish_Light_Infantry"
"Spain_Spa_Inf_Militia_Spanish_Provincial_Militia"	"spa_spain"	"Spain_Spa_Inf_Militia_Spanish_Provincial_Militia"	"Inf_Militia_Spanish_Provincial_Militia"
"Spain_Spa_Inf_Mob_Armed_Citizenry"	"spa_spain"	"Spain_Spa_Inf_Mob_Armed_Citizenry"	"Inf_Mob_Armed_Citizenry"
"Spain_Art_Foot_Spanish_12_lber"	"spain"	"Spain_Art_Foot_Spanish_12_lber"	"Art_Foot_Spanish_12_lber"
"Spain_Art_Foot_Spanish_9_lber"	"spain"	"Spain_Art_Foot_Spanish_9_lber"	"Art_Foot_Spanish_9_lber"
"Spain_Cav_Heavy_Republican_Horse_Guards"	"spain"	"Spain_Cav_Heavy_Republican_Horse_Guards"	"Cav_Heavy_Republican_Horse_Guards"
"Spain_Cav_Heavy_Spanish_Dragoons"	"spain"	"Spain_Cav_Heavy_Spanish_Dragoons"	"Cav_Heavy_Spanish_Dragoons"
"Spain_Cav_Heavy_Spanish_Guardias_da_Corp"	"spain"	"Spain_Cav_Heavy_Spanish_Guardias_da_Corp"	"Cav_Heavy_Spanish_Guardias_da_Corp"
"Spain_Cav_Light_Spanish_Hussars"	"spain"	"Spain_Cav_Light_Spanish_Hussars"	"Cav_Light_Spanish_Hussars"
"Spain_Cav_Stand_Spanish_Line_Cavalry"	"spain"	"Spain_Cav_Stand_Spanish_Line_Cavalry"	"Cav_Stand_Spanish_Line_Cavalry"
"Spain_Gen_Francisco_Castanos"	"spain"	"Spain_Gen_Francisco_Castanos"	"Gen_Francisco_Castanos"
"Spain_Gen_Generals_Staff"	"spain"	"Spain_Gen_Generals_Staff"	"Gen_Generals_Staff"
"France_Spa_Inf_Elite_French_Young_Guard"	"spa_france"	"France_Spa_Inf_Elite_French_Young_Guard"	"Inf_Elite_French_Young_Guard"
"Spain_Spa_Inf_Gren_Spanish_Grenadiers"	"spa_spain"	"Spain_Spa_Inf_Gren_Spanish_Grenadiers"	"Inf_Gren_Spanish_Grenadiers"
"Britain_Spa_Inf_Light_Portuguese_Cazadores"	"spa_britain"	"Portugal_Spa_Inf_Light_Portuguese_Cazadores"	"Inf_Light_British_Portuguese_Cazadores_Auxiliary"
"Spain_Spa_Inf_Line_Spanish_Fusiliers"	"spa_spain"	"Spain_Spa_Inf_Line_Spanish_Fusiliers"	"Inf_Line_Spanish_Fusiliers"
"Spain_Gen_Gregorio_Garcia_de_la_Cuesta"	"spain"	"Spain_Gen_Gregorio_Garcia_de_la_Cuesta"	"Gen_Gregorio_Garcia_de_la_Cuesta"
"Spain_Gen_Joaquin_Blake_y_Joyes"	"spain"	"Spain_Gen_Joaquin_Blake_y_Joyes"	"Gen_Joaquin_Blake_y_Joyes"
"Spain_Inf_Elite_Republican_Guards"	"spain"	"Spain_Inf_Elite_Republican_Guards"	"Inf_Elite_Republican_Guards"
"Spain_Inf_Elite_Spanish_Guardias_de_Infanteria"	"spain"	"Spain_Inf_Elite_Spanish_Guardias_de_Infanteria"	"Inf_Elite_Spanish_Guardias_de_Infanteria"
"Spain_Inf_Gren_Spanish_Grenadiers"	"spain"	"Spain_Inf_Gren_Spanish_Grenadiers"	"Inf_Gren_Spanish_Grenadiers"
"Spain_Inf_Irreg_Spanish_Guerillas"	"spain"	"Spain_Inf_Irreg_Spanish_Guerillas"	"Inf_Irreg_Spanish_Guerillas"
"Spain_Inf_Light_Spanish_Cazadores"	"spain"	"Spain_Inf_Light_Spanish_Cazadores"	"Inf_Light_Spanish_Cazadores"
"Spain_Inf_Line_Spanish_Line_Infantry"	"spain"	"Spain_Inf_Line_Spanish_Line_Infantry"	"Inf_Line_Spanish_Line_Infantry"
"Spain_Inf_Militia_Spanish_Provincial_Militia"	"spain"	"Spain_Inf_Militia_Spanish_Provincial_Militia"	"Inf_Militia_Spanish_Provincial_Militia"
"Spain_Inf_Mob_Armed_Citizenry"	"spain"	"Spain_Inf_Mob_Armed_Citizenry"	"Inf_Mob_Armed_Citizenry"
"Spain_Mounted_Inf_Spanish_Mounted_Cazadores"	"spain"	"Spain_Mounted_Inf_Spanish_Mounted_Cazadores"	"Mounted_Inf_Spanish_Mounted_Cazadores"
"Spanish_Rebels_Art_Foot_12_lber"	"spanish_rebels"	"Spanish_Rebels_Art_Foot_12_lber"	"Art_Foot_12_lber"
"Spanish_Rebels_Art_Foot_7_lber_Howitzer"	"spanish_rebels"	"Spanish_Rebels_Art_Foot_7_lber_Howitzer"	"Art_Foot_7_lber_Howitzer"
"Spanish_Rebels_Art_Horse_6_lber"	"spanish_rebels"	"Spanish_Rebels_Art_Horse_6_lber"	"Art_Horse_6_lber"
"Spanish_Rebels_Cav_Heavy_Dragoons"	"spanish_rebels"	"Spanish_Rebels_Cav_Heavy_Dragoons"	"Cav_Heavy_Dragoons"
"Spanish_Rebels_Cav_Light_Hussars"	"spanish_rebels"	"Spanish_Rebels_Cav_Light_Hussars"	"Cav_Light_Hussars"
"Spanish_Rebels_Gen_Generals_Staff"	"spanish_rebels"	"Spanish_Rebels_Gen_Generals_Staff"	"Gen_Generals_Staff"
"Spanish_Rebels_Inf_Light_Light_Infantry"	"spanish_rebels"	"Spanish_Rebels_Inf_Light_Light_Infantry"	"Inf_Light_Light_Infantry"
"Spanish_Rebels_Inf_Line_Line_Infantry"	"spanish_rebels"	"Spanish_Rebels_Inf_Line_Line_Infantry"	"Inf_Line_Line_Infantry"
"Spanish_Rebels_Inf_Militia_Militia"	"spanish_rebels"	"Spanish_Rebels_Inf_Militia_Militia"	"Inf_Militia_Militia"
"Spanish_Rebels_Inf_Mob_Armed_Citizenry"	"spanish_rebels"	"Spanish_Rebels_Inf_Mob_Armed_Citizenry"	"Inf_Mob_Armed_Citizenry"
"Sweden_Art_Foot_12_lber"	"sweden"	"Sweden_Art_Foot_12_lber"	"Art_Foot_12_lber"
"Sweden_Art_Foot_6_lber"	"sweden"	"Sweden_Art_Foot_6_lber"	"Art_Foot_6_lber"
"Sweden_Art_Foot_7_lber_Howitzer"	"sweden"	"Sweden_Art_Foot_7_lber_Howitzer"	"Art_Foot_7_lber_Howitzer"
"Sweden_Art_Horse_6_lber"	"sweden"	"Sweden_Art_Horse_6_lber"	"Art_Horse_6_lber"
"Sweden_Cav_Heavy_Dragoons"	"sweden"	"Sweden_Cav_Heavy_Dragoons"	"Cav_Heavy_Dragoons"
"Sweden_Cav_Heavy_Life_Guards_of_Horse"	"sweden"	"Sweden_Cav_Heavy_Life_Guards_of_Horse"	"Cav_Heavy_Life_Guards_of_Horse"
"Sweden_Cav_Heavy_Republican_Horse_Guards"	"sweden"	"Sweden_Cav_Heavy_Republican_Horse_Guards"	"Cav_Heavy_Republican_Horse_Guards"
"Sweden_Cav_Light_Hussars"	"sweden"	"Sweden_Cav_Light_Hussars"	"Cav_Light_Hussars"
"Sweden_Gen_Anders_Fredrik_Skjoldebrand"	"sweden"	"Sweden_Gen_Anders_Fredrik_Skjoldebrand"	"Gen_Anders_Fredrik_Skjoldebrand"
"Sweden_Gen_Bernadotte"	"sweden"	"Sweden_Gen_Bernadotte"	"Gen_Bernadotte"
"Sweden_Gen_Generals_Staff"	"sweden"	"Sweden_Gen_Generals_Staff"	"Gen_Generals_Staff"
"Sweden_Gen_Hans_Henric_von_Essen"	"sweden"	"Sweden_Gen_Hans_Henric_von_Essen"	"Gen_Hans_Henric_von_Essen"
"Sweden_Inf_Elite_Life_Guards_of_Foot"	"sweden"	"Sweden_Inf_Elite_Life_Guards_of_Foot"	"Inf_Elite_Life_Guards_of_Foot"
"Sweden_Inf_Elite_Republican_Guards"	"sweden"	"Sweden_Inf_Elite_Republican_Guards"	"Inf_Elite_Republican_Guards"
"Sweden_Inf_Line_Line_Infantry"	"sweden"	"Sweden_Inf_Line_Line_Infantry"	"Inf_Line_Line_Infantry"
"Sweden_Inf_Militia_Militia"	"sweden"	"Sweden_Inf_Militia_Militia"	"Inf_Militia_Militia"
"Sweden_Inf_Mob_Armed_Citizenry"	"sweden"	"Sweden_Inf_Mob_Armed_Citizenry"	"Inf_Mob_Armed_Citizenry"
"Sweden_Inf_Skirm_Jager"	"sweden"	"Sweden_Inf_Skirm_Jager"	"Inf_Skirm_Jager"
"Sweden_Mounted_Inf_Swedish_Mounted_Jager"	"sweden"	"Sweden_Mounted_Inf_Swedish_Mounted_Jager"	"Mounted_Inf_Swedish_Mounted_Jager"
"Swiss_Art_Foot_6_lber"	"swiss_confederation"	"Swiss_Art_Foot_6_lber"	"Art_Foot_6_lber"
"Swiss_Art_Horse_6_lber"	"swiss_confederation"	"Swiss_Art_Horse_6_lber"	"Art_Horse_6_lber"
"Swiss_Cav_Heavy_Dragoons"	"swiss_confederation"	"Swiss_Cav_Heavy_Dragoons"	"Cav_Heavy_Dragoons"
"Swiss_Cav_Stand_Chevauxlegers"	"swiss_confederation"	"Swiss_Cav_Stand_Chevauxlegers"	"Cav_Stand_Chevauxlegers"
"Swiss_Gen_Generals_Staff"	"swiss_confederation"	"Swiss_Gen_Generals_Staff"	"Gen_Generals_Staff"
"Swiss_Inf_Line_Line_Infantry"	"swiss_confederation"	"Swiss_Inf_Line_Line_Infantry"	"Inf_Line_Line_Infantry"
"Swiss_Inf_Militia_Militia"	"swiss_confederation"	"Swiss_Inf_Militia_Militia"	"Inf_Militia_Militia"
"Swiss_Inf_Mob_Armed_Citizenry"	"swiss_confederation"	"Swiss_Inf_Mob_Armed_Citizenry"	"Inf_Mob_Armed_Citizenry"
"Tut_Britain_Art_Foot_British_6_lber"	"tut_britain"	"Tut_Britain_Art_Foot_British_6_lber"	"Art_Foot_British_6_lber"
"Tut_Britain_Gen_Generals_Staff"	"tut_britain"	"Tut_Britain_Gen_Generals_Staff"	"Gen_Generals_Staff"
"Tut_Britain_Inf_Line_British_Foot"	"tut_britain"	"Tut_Britain_Inf_Line_British_Foot"	"Inf_Line_British_Foot"
"Tut_Britain_Inf_Militia_Militia"	"tut_britain"	"Tut_Britain_Inf_Militia_Militia"	"Inf_Militia_Militia"
"Tut_France_Art_Foot_French_12_lber"	"tut_france"	"Tut_France_Art_Foot_French_12_lber"	"Art_Foot_French_12_lber"
"Tut_France_Art_Foot_French_6_lber"	"tut_france"	"Tut_France_Art_Foot_French_6_lber"	"Art_Foot_French_Tutorial_6_lber"
"Tut_France_Cav_Heavy_French_Dragoons"	"tut_france"	"Tut_France_Cav_Heavy_French_Dragoons"	"Cav_Heavy_French_Tutorial_Dragoons"
"Tut_France_Gen_Early_Napoleon"	"tut_france"	"Tut_France_Gen_Early_Napoleon"	"Gen_Early_Napoleon"
"Tut_France_Gen_Generals_Staff_Foot"	"tut_france"	"Tut_France_Gen_Generals_Staff_Foot"	"Gen_Generals_Staff_Foot"
"Tut_France_Inf_Line_French_Revolutionary_Infantry"	"tut_france"	"Tut_France_Inf_Line_French_Revolutionary_Infantry"	"Inf_Line_French_Revolutionary_Infantry"
"Tut_France_Inf_Line_French_Tutorial_Fusiliers"	"tut_france"	"Tut_France_Inf_Line_French_Tutorial_Fusiliers"	"Inf_Line_French_Tutorial_Fusiliers"
"Tut_France_Inf_Militia_French_National_Guard"	"tut_france"	"Tut_France_Inf_Militia_French_National_Guard"	"Inf_Militia_French_National_Guard"
"Tut_Sardinia_Cav_Heavy_Dragoons"	"tut_sardinia"	"Tut_Sardinia_Cav_Heavy_Dragoons"	"Cav_Heavy_Dragoons"
"Tut_Sardinia_Gen_Generals_Staff"	"tut_sardinia"	"Tut_Sardinia_Gen_Generals_Staff"	"Gen_Generals_Staff"
"Tut_Sardinia_Inf_Gren_Grenadiers"	"tut_sardinia"	"Tut_Sardinia_Inf_Gren_Grenadiers"	"Inf_Gren_Grenadiers"
"Tut_Sardinia_Inf_Line_Line_Infantry"	"tut_sardinia"	"Tut_Sardinia_Inf_Line_Line_Infantry"	"Inf_Line_Line_Infantry"
"Tut_Sardinia_Inf_Militia_Militia"	"tut_sardinia"	"Tut_Sardinia_Inf_Militia_Militia"	"Inf_Militia_Militia"
"Tut_Swiss_Art_Foot_6_lber"	"tut_swiss_confederation"	"Tut_Swiss_Art_Foot_6_lber"	"Art_Foot_6_lber"
"Tut_Swiss_Cav_Heavy_Dragoons"	"tut_swiss_confederation"	"Tut_Swiss_Cav_Heavy_Dragoons"	"Cav_Heavy_Dragoons"
"Tut_Swiss_Gen_Generals_Staff"	"tut_swiss_confederation"	"Tut_Swiss_Gen_Generals_Staff"	"Gen_Generals_Staff"
"Tut_Swiss_Inf_Line_Line_Infantry"	"tut_swiss_confederation"	"Tut_Swiss_Inf_Line_Line_Infantry"	"Inf_Line_Line_Infantry"
"Tut_Swiss_Inf_Militia_Militia"	"tut_swiss_confederation"	"Tut_Swiss_Inf_Militia_Militia"	"Inf_Militia_Militia"
"United_Netherlands_Art_Foot_12_lber"	"united_netherlands"	"United_Netherlands_Art_Foot_12_lber"	"Art_Foot_12_lber"
"United_Netherlands_Art_Foot_6_lber"	"united_netherlands"	"United_Netherlands_Art_Foot_6_lber"	"Art_Foot_6_lber"
"United_Netherlands_Art_Foot_7_lber_Howitzer"	"united_netherlands"	"United_Netherlands_Art_Foot_7_lber_Howitzer"	"Art_Foot_7_lber_Howitzer"
"United_Netherlands_Art_Horse_6_lber"	"united_netherlands"	"United_Netherlands_Art_Horse_6_lber"	"Art_Horse_6_lber"
"United_Netherlands_Cav_Heavy_Carabiniers"	"united_netherlands"	"United_Netherlands_Cav_Heavy_Carabiniers"	"Cav_Heavy_Carabiniers"
"United_Netherlands_Cav_Light_Hussars"	"united_netherlands"	"United_Netherlands_Cav_Light_Hussars"	"Cav_Light_Hussars"
"United_Netherlands_Cav_Light_Light_Dragoons"	"united_netherlands"	"United_Netherlands_Cav_Light_Light_Dragoons"	"Cav_Light_Light_Dragoons"
"United_Netherlands_Cav_Stand_Chevauxlegers"	"united_netherlands"	"United_Netherlands_Cav_Stand_Chevauxlegers"	"Cav_Stand_Chevauxlegers"
"United_Netherlands_Gen_David_Hendrik_Chasse"	"united_netherlands"	"United_Netherlands_Gen_David_Hendrik_Chasse"	"Gen_David_Hendrik_Chasse"
"United_Netherlands_Gen_Generals_Staff"	"united_netherlands"	"United_Netherlands_Gen_Generals_Staff"	"Gen_Generals_Staff"
"United_Netherlands_Gen_Jean_Victor_baron_de_Constant_Rebecque"	"united_netherlands"	"United_Netherlands_Gen_Jean_Victor_baron_de_Constant_Rebecque"	"Gen_Jean_Victor_baron_de_Constant_Rebecque"
"United_Netherlands_Gen_Prince_of_Orange"	"united_netherlands"	"United_Netherlands_Gen_Prince_of_Orange"	"Gen_Prince_of_Orange"
"United_Netherlands_Inf_Gren_Grenadiers"	"united_netherlands"	"United_Netherlands_Inf_Gren_Grenadiers"	"Inf_Gren_Grenadiers"
"United_Netherlands_Inf_Light_Dutch_Flanquers"	"united_netherlands"	"United_Netherlands_Inf_Light_Dutch_Flanquers"	"Inf_Light_Dutch_Flanquers"
"United_Netherlands_Inf_Line_Line_Infantry"	"united_netherlands"	"United_Netherlands_Inf_Line_Line_Infantry"	"Inf_Line_Line_Infantry"
"United_Netherlands_Inf_Militia_Militiamen"	"united_netherlands"	"United_Netherlands_Inf_Militia_Militiamen"	"Inf_Militia_Militiamen"
"United_Netherlands_Inf_Mob_Armed_Citizenry"	"united_netherlands"	"United_Netherlands_Inf_Mob_Armed_Citizenry"	"Inf_Mob_Armed_Citizenry"
"United_Netherlands_Inf_Skirm_Jager"	"united_netherlands"	"United_Netherlands_Inf_Skirm_Jager"	"Inf_Skirm_Nassau_Jager"
"Westphalia_Art_Foot_12_lber"	"westphalia"	"Westphalia_Art_Foot_12_lber"	"Art_Foot_12_lber"
"Westphalia_Art_Foot_6_lber"	"westphalia"	"Westphalia_Art_Foot_6_lber"	"Art_Foot_6_lber"
"Westphalia_Art_Foot_7_lber_Howitzer"	"westphalia"	"Westphalia_Art_Foot_7_lber_Howitzer"	"Art_Foot_7_lber_Howitzer"
"Westphalia_Art_Horse_6_lber"	"westphalia"	"Westphalia_Art_Horse_6_lber"	"Art_Horse_6_lber"
"Westphalia_Cav_Heavy_Cuirassiers"	"westphalia"	"Westphalia_Cav_Heavy_Cuirassiers"	"Cav_Heavy_Cuirassiers"
"Westphalia_Cav_Heavy_Garde_du_Corp"	"westphalia"	"Westphalia_Cav_Heavy_Garde_du_Corp"	"Cav_Heavy_Garde_du_Corp"
"Westphalia_Cav_Light_Hussars"	"westphalia"	"Westphalia_Cav_Light_Hussars"	"Cav_Light_Hussars"
"Westphalia_Cav_Stand_Chevauxlegers"	"westphalia"	"Westphalia_Cav_Stand_Chevauxlegers"	"Cav_Stand_Chevauxlegers"
"Westphalia_Gen_Generals_Staff"	"westphalia"	"Westphalia_Gen_Generals_Staff"	"Gen_Generals_Staff"
"Westphalia_Inf_Elite_Grenadier_Guards"	"westphalia"	"Westphalia_Inf_Elite_Grenadier_Guards"	"Inf_Elite_Grenadier_Guards"
"Westphalia_Inf_Light_Light_Infantry"	"westphalia"	"Westphalia_Inf_Light_Light_Infantry"	"Inf_Light_Light_Infantry"
"Westphalia_Inf_Line_Line_Infantry"	"westphalia"	"Westphalia_Inf_Line_Line_Infantry"	"Inf_Line_Line_Infantry"
"Westphalia_Inf_Militia_Militia"	"westphalia"	"Westphalia_Inf_Militia_Militia"	"Inf_Militia_Militia"
"Westphalia_Inf_Mob_Armed_Citizenry"	"westphalia"	"Westphalia_Inf_Mob_Armed_Citizenry"	"Inf_Mob_Armed_Citizenry"
"Wurrtemberg_Art_Foot_12_lber"	"wurttemberg"	"Wurrtemberg_Art_Foot_12_lber"	"Art_Foot_12_lber"
"Wurrtemberg_Art_Foot_6_lber"	"wurttemberg"	"Wurrtemberg_Art_Foot_6_lber"	"Art_Foot_6_lber"
"Wurrtemberg_Art_Foot_7_lber_Howitzer"	"wurttemberg"	"Wurrtemberg_Art_Foot_7_lber_Howitzer"	"Art_Foot_7_lber_Howitzer"
"Wurrtemberg_Art_Horse_6_lber"	"wurttemberg"	"Wurrtemberg_Art_Horse_6_lber"	"Art_Horse_6_lber"
"Wurrtemberg_Cav_Heavy_Cuirassiers"	"wurttemberg"	"Wurrtemberg_Cav_Heavy_Cuirassiers"	"Cav_Heavy_Cuirassiers"
"Wurrtemberg_Cav_Stand_Chevauxlegers"	"wurttemberg"	"Wurrtemberg_Cav_Stand_Chevauxlegers"	"Cav_Stand_Chevauxlegers"
"Wurrtemberg_Gen_Generals_Staff"	"wurttemberg"	"Wurrtemberg_Gen_Generals_Staff"	"Gen_Generals_Staff"
"Wurrtemberg_Inf_Light_Light_Infantry"	"wurttemberg"	"Wurrtemberg_Inf_Light_Light_Infantry"	"Inf_Light_Light_Infantry"
"Wurrtemberg_Inf_Line_Line_Infantry"	"wurttemberg"	"Wurrtemberg_Inf_Line_Line_Infantry"	"Inf_Line_Line_Infantry"
"Wurrtemberg_Inf_Militia_Landwehr"	"wurttemberg"	"Wurrtemberg_Inf_Militia_Landwehr"	"Inf_Militia_Landwehr"
"Wurrtemberg_Inf_Mob_Armed_Citizenry"	"wurttemberg"	"Wurrtemberg_Inf_Mob_Armed_Citizenry"	"Inf_Mob_Armed_Citizenry"
"Wurrtemberg_Inf_Skirm_Jager"	"wurttemberg"	"Wurrtemberg_Inf_Skirm_Jager"	"Inf_Skirm_Jager"
"Ottomans_Egy_Gen_Ahmed_Al-Jazzar"	"egy_ottomans"	"Ottomans_Egy_Gen_Ahmed_Al-Jazzar"	"Gen_Ahmed_Al-Jazzar"
"Imperial_Guards_Cav_Heavy_French_Empress_Dragoons"	"france"	"Imperial_Guards_Cav_Heavy_French_Empress_Dragoons"	"Cav_Heavy_French_Empress_Dragoons"
"Imperial_Guards_Inf_Elite_French_Dutch_Grenadiers"	"france"	"Imperial_Guards_Inf_Elite_French_Dutch_Grenadiers"	"Inf_Elite_French_Dutch_Grenadiers"
"Imperial_Guards_Inf_Elite_French_Guard_Seamen"	"france"	"Imperial_Guards_Inf_Elite_French_Guard_Seamen"	"Inf_Elite_French_Guard_Seamen"
"Imperial_Guards_Cav_Light_French_Guard_Chasseurs_a_Cheval"	"france"	"Imperial_Guards_Cav_Light_French_Guard_Chasseurs_a_Cheval"	"Cav_Light_French_Guard_Chasseurs_a_Cheval"
"Imperial_Guards_Cav_Lancer_French_Polish_Guard_Lancers"	"france"	"Imperial_Guards_Cav_Lancer_French_Polish_Guard_Lancers"	"Cav_Lancer_French_Polish_Guard_Lancers"
"Imperial_Guards_Cav_Lancer_French_Dutch_Guard_Lancers"	"france"	"Imperial_Guards_Cav_Lancer_French_Dutch_Guard_Lancers"	"Cav_Lancer_French_Dutch_Guard_Lancers"
"Britain_Spa_Inf_Line_Portuguese_Infantry"	"spa_britain"	"Portugal_Spa_Inf_Line_Portuguese_Infantry"	"Inf_Line_British_Portuguese_Infantry_Auxiliary"
"France_Spa_Cav_Lancer_French_Vistula_Uhlans"	"spa_france"	"France_Spa_Cav_Lancer_French_Vistula_Uhlans"	"Cav_Lancer_French_Vistula_Uhlans"
"Britain_Spa_Cav_Light_Guerilla_Husares_Guerilla"	"spa_britain"	"Spain_Spa_Cav_Light_Guerilla_Husares_Guerilla"	"Cav_Light_Spanish_Guerilla_Husares_Guerrilla"
"Spain_Spa_Cav_Light_Guerilla_Husares_Guerilla"	"spa_spain"	"Spain_Spa_Cav_Light_Guerilla_Husares_Guerilla"	"Cav_Light_Spanish_Guerilla_Husares_Guerrilla"
"Britain_Spa_Cav_Light_Husares_de_Cantabria_Guerrilla"	"spa_britain"	"Spain_Spa_Cav_Light_Husares_de_Cantabria_Guerrilla"	"Cav_Light_Spanish_Husares_de_Cantabria_Guerrilla"
"Spain_Spa_Cav_Light_Husares_Burgos_Guerilla"	"spa_spain"	"Spain_Spa_Cav_Light_Husares_Burgos_Guerilla"	"Cav_Light_Spanish_Husares_Burgos_Guerrilla"
"Britain_Spa_Cav_Light_Husares_Burgos_Guerilla"	"spa_britain"	"Spain_Spa_Cav_Light_Husares_Burgos_Guerilla"	"Cav_Light_Spanish_Husares_Burgos_Guerrilla"
"Spain_Spa_Cav_Light_Husares_de_Cantabria_Guerrilla"	"spa_spain"	"Spain_Spa_Cav_Light_Husares_de_Cantabria_Guerrilla"	"Cav_Light_Spanish_Husares_de_Cantabria_Guerrilla"
"Britain_Spa_Cav_Light_Husares_de_Rioja_Guerrilla"	"spa_britain"	"Spain_Spa_Cav_Light_Husares_de_Rioja_Guerrilla"	"Cav_Light_Spanish_Husares_de_Rioja_Guerrilla"
"Spain_Spa_Cav_Light_Husares_de_Rioja_Guerrilla"	"spa_spain"	"Spain_Spa_Cav_Light_Husares_de_Rioja_Guerrilla"	"Cav_Light_Spanish_Husares_de_Rioja_Guerrilla"
"Britain_Spa_Cav_Light_Husares_de_Valpenas_Guerilla"	"spa_britain"	"Spain_Spa_Cav_Light_Husares_de_Valpenas_Guerilla"	"Cav_Light_Spanish_Husares_de_Valpenas_Guerrilla"
"Spain_Spa_Cav_Light_Husares_de_Valpenas_Guerilla"	"spa_spain"	"Spain_Spa_Cav_Light_Husares_de_Valpenas_Guerilla"	"Cav_Light_Spanish_Husares_de_Valpenas_Guerrilla"
"Britain_Spa_Cav_Light_Husares_Extremadura_Guerilla"	"spa_britain"	"Spain_Spa_Cav_Light_Husares_Extremadura_Guerilla"	"Cav_Light_Spanish_Husares_Extremadura_Guerrilla"
"Spain_Spa_Cav_Light_Husares_Extremadura_Guerilla"	"spa_spain"	"Spain_Spa_Cav_Light_Husares_Extremadura_Guerilla"	"Cav_Light_Spanish_Husares_Extremadura_Guerrilla"
"Britain_Spa_Cav_Light_Husares_Numantinos_Guerilla"	"spa_britain"	"Spain_Spa_Cav_Light_Husares_Numantinos_Guerilla"	"Cav_Light_Spanish_Husares_Numantinos_Guerrilla"
"Spain_Spa_Cav_Light_Husares_Numantinos_Guerilla"	"spa_spain"	"Spain_Spa_Cav_Light_Husares_Numantinos_Guerilla"	"Cav_Light_Spanish_Husares_Numantinos_Guerrilla"
"Britain_Spa_Cav_Stand_Voluntarios_Ciudad_Guerrilla"	"spa_britain"	"Spain_Spa_Cav_Stand_Voluntarios_Ciudad_Guerrilla"	"Cav_Stand_Spanish_Voluntarios_Ciudad_Guerrilla"
"Spain_Spa_Cav_Stand_Voluntarios_Ciudad_Guerrilla"	"spa_spain"	"Spain_Spa_Cav_Stand_Voluntarios_Ciudad_Guerrilla"	"Cav_Stand_Spanish_Voluntarios_Ciudad_Guerrilla"
"Britain_Spa_Gen_Guerilla_Leader_Guerilla"	"spa_britain"	"Spain_Spa_Gen_Guerilla_Leader_Guerrilla"	"Gen_British_Guerilla_Leader_Guerrilla"
"Britain_Spa_Inf_Irreg_Corso_Terrestre_Guerrilla"	"spa_britain"	"Spain_Spa_Inf_Irreg_Corso_Terrestre_Guerrilla"	"Inf_Irreg_Spanish_Corso_Terrestre_Guerrilla"
"Spain_Spa_Inf_Irreg_Corso_Terrestre_Guerrilla"	"spa_spain"	"Spain_Spa_Inf_Irreg_Corso_Terrestre_Guerrilla"	"Inf_Irreg_Spanish_Corso_Terrestre_Guerrilla"
"Britain_Spa_Inf_Light_Cazadores_de_Cataluna_Guerrilla"	"spa_britain"	"Spain_Spa_Inf_Light_Cazadores_de_Cataluna_Guerrilla"	"Inf_Light_Spanish_Cazadores_de_Cataluna_Guerrilla"
"Spain_Spa_Inf_Light_Cazadores_de_Cataluna_Guerrilla"	"spa_spain"	"Spain_Spa_Inf_Light_Cazadores_de_Cataluna_Guerrilla"	"Inf_Light_Spanish_Cazadores_de_Cataluna_Guerrilla"
"Britain_Spa_Inf_Light_Cazadores_Numantinos_Guerrilla"	"spa_britain"	"Spain_Spa_Inf_Light_Cazadores_Numantinos_Guerrilla"	"Inf_Light_Spanish_Cazadores_Numantinos_Guerrilla"
"Spain_Spa_Inf_Light_Cazadores_Numantinos_Guerrilla"	"spa_spain"	"Spain_Spa_Inf_Light_Cazadores_Numantinos_Guerrilla"	"Inf_Light_Spanish_Cazadores_Numantinos_Guerrilla"
"Britain_Spa_Inf_Light_Regimento_de_Arlanza_Guerrilla"	"spa_britain"	"Spain_Spa_Inf_Light_Regimento_de_Arlanza_Guerrilla"	"Inf_Light_Spanish_Regimento_de_Arlanza_Guerrilla"
"Spain_Spa_Inf_Light_Regimento_de_Arlanza_Guerrilla"	"spa_spain"	"Spain_Spa_Inf_Light_Regimento_de_Arlanza_Guerrilla"	"Inf_Light_Spanish_Regimento_de_Arlanza_Guerrilla"
"Britain_Spa_Inf_Line_Voluntarios_de_Coruna_Guerilla"	"spa_britain"	"Spain_Spa_Inf_Line_Voluntarios_de_Coruna_Guerilla"	"Inf_Line_Spanish_Voluntarios_de_Coruna_Guerrilla"
"Spain_Spa_Inf_Line_Voluntarios_de_Coruna_Guerilla"	"spa_spain"	"Spain_Spa_Inf_Line_Voluntarios_de_Coruna_Guerilla"	"Inf_Line_Spanish_Voluntarios_de_Coruna_Guerrilla"
"Britain_Spa_Inf_Line_Voluntarios_Tietar_Guerrilla"	"spa_britain"	"Spain_Spa_Inf_Line_Voluntarios_Tietar_Guerrilla"	"Inf_Line_Spanish_Voluntarios_Tietar_Guerrilla"
"Spain_Spa_Inf_Line_Voluntarios_Tietar_Guerrilla"	"spa_spain"	"Spain_Spa_Inf_Line_Voluntarios_Tietar_Guerrilla"	"Inf_Line_Spanish_Voluntarios_Tietar_Guerrilla"
"Britain_Spa_Inf_Skirm_Guerilla_Tiradores_Guerilla"	"spa_britain"	"Spain_Spa_Inf_Skirm_Guerilla_Tiradores_Guerilla"	"Inf_Skirm_Spanish_Guerilla_Tiradores_Guerrilla"
"Spain_Spa_Inf_Skirm_Guerilla_Tiradores_Guerilla"	"spa_spain"	"Spain_Spa_Inf_Skirm_Guerilla_Tiradores_Guerilla"	"Inf_Skirm_Spanish_Guerilla_Tiradores_Guerrilla"
"Britain_Spa_Inf_Skirm_Tiradores_de_Cantabria_Guerrilla"	"spa_britain"	"Spain_Spa_Inf_Skirm_Tiradores_de_Cantabria_Guerrilla"	"Inf_Skirm_Spanish_Tiradores_de_Cantabria_Guerrilla"
"Spain_Spa_Inf_Skirm_Tiradores_de_Cantabria_Guerrilla"	"spa_spain"	"Spain_Spa_Inf_Skirm_Tiradores_de_Cantabria_Guerrilla"	"Inf_Skirm_Spanish_Tiradores_de_Cantabria_Guerrilla"
"Britain_Spa_Mounted_Inf_Voluntarios_Madrid_Guerilla"	"spa_britain"	"Spain_Spa_Mounted_Inf_Voluntarios_Madrid_Guerilla"	"Mounted_Inf_Spanish_Voluntarios_Madrid_Guerrilla"
"Spain_Spa_Mounted_Inf_Voluntarios_Madrid_Guerilla"	"spa_spain"	"Spain_Spa_Mounted_Inf_Voluntarios_Madrid_Guerilla"	"Mounted_Inf_Spanish_Voluntarios_Madrid_Guerrilla"
"Spain_Spa_Inf_Light_Guerilla_Cazadores_Guerilla"	"spa_spain"	"Spain_Spa_Inf_Light_Guerilla_Cazadores_Guerilla"	"Inf_Light_Spanish_Guerilla_Cazadores_Guerrilla"
"Britain_Spa_Inf_Light_Guerilla_Cazadores_Guerilla"	"spa_britain"	"Spain_Spa_Inf_Light_Guerilla_Cazadores_Guerilla"	"Inf_Light_Spanish_Guerilla_Cazadores_Guerrilla"
"Britain_Spa_Cav_Light_Spanish_Hussars"	"spa_britain"	"Spain_Spa_Cav_Light_Spanish_Hussars"	"Cav_Light_British_Spanish_Hussars_Auxiliary"
"France_Spa_Inf_Skirm_French_Contra-Guerillas"	"spa_france"	"France_Spa_Inf_Skirm_French_Contra-Guerillas"	"Inf_Skirm_French_Contra-Guerillas"
"Russia_Cav_Light_Russian_Lifeguard_Hussars"	"russia"	"Russia_Cav_Light_Russian_Lifeguard_Hussars"	"Cav_Light_Russian_Lifeguard_Hussars"
"Russia_Inf_Elite_Russian_Semenovski_Lifeguard"	"russia"	"Russia_Inf_Elite_Russian_Semenovski_Lifeguard"	"Inf_Elite_Russian_Semenovski_Lifeguard"
"Britain_Inf_Elite_British_Coldstream_Guards"	"britain"	"Britain_Inf_Elite_British_Coldstream_Guards"	"Inf_Elite_British_Coldstream_Guards"
"Austria_Inf_Line_Austrian_Archduke_Charles_Legion"	"austria"	"Austria_Inf_Line_Austrian_Archduke_Charles_Legion"	"Inf_Line_Austrian_Archduke_Charles_Legion"
"Britain_Spa_Inf_Militia_Portuguese_Militia"	"spa_britain"	"Portugal_Spa_Inf_Militia_Portuguese_Militia"	"Inf_Militia_British_Portuguese_Militia_Auxiliary"
"Britain_Spa_Inf_Line_Brunswick_Line_Infantry"	"spa_britain"	"Britain_Spa_Inf_Line_Brunswick_Line_Infantry"	"Inf_Line_Brunswick_Line_Infantry"
"Britain_Spa_Art_Foot_Spanish_9_lber"	"spa_britain"	"Spain_Spa_Art_Foot_Spanish_9_lber"	"Art_Foot_British_Spanish_9_lber_Auxiliary"
"Britain_Spa_Inf_Light_Spanish_Light_Infantry"	"spa_britain"	"Spain_Spa_Inf_Light_Spanish_Light_Infantry"	"Inf_Light_British_Spanish_Light_Infantry_Auxiliary"
"Britain_Spa_Inf_Line_Spanish_Fusiliers"	"spa_britain"	"Spain_Spa_Inf_Line_Spanish_Fusiliers"	"Inf_Line_British_Spanish_Fusiliers_Auxiliary"
"Spain_Spa_Inf_Elite_Spanish_Walloon_Guards"	"spa_spain"	"Spain_Spa_Inf_Elite_Spanish_Walloon_Guards"	"Inf_Elite_Spanish_Walloon_Guards"
"Spain_Spa_Cav_Lancer_Spanish_Lanceros"	"spa_spain"	"Spain_Spa_Cav_Lancer_Spanish_Lanceros"	"Cav_Lancer_Spanish_Lanceros"
"Spain_Spa_Cav_Heavy_Spanish_Coraceros_Espanoles"	"spa_spain"	"Spain_Spa_Cav_Heavy_Spanish_Coraceros_Espanoles"	"Cav_Heavy_Spanish_Coraceros_Espanoles"
"Spain_Spa_Art_Horse_Spanish_6_lber"	"spa_spain"	"Spain_Spa_Art_Horse_Spanish_6_lber"	"Art_Horse_Spanish_6_lber"
"Britain_Spa_Inf_Militia_Spanish_Provincial_Militia"	"spa_britain"	"Spain_Spa_Inf_Militia_Spanish_Provincial_Militia"	"Inf_Militia_British_Spanish_Militia_Auxiliary"
"Britain_Spa_Cav_Lancer_Guerilla_Lanceros_Guerilla"	"spa_britain"	"Spain_Spa_Cav_Lancer_Guerilla_Lanceros_Guerilla"	"Cav_Lancer_Spanish_Guerilla_Lanceros_Guerrilla"
"Spain_Spa_Cav_Lancer_Guerilla_Lanceros_Guerilla"	"spa_spain"	"Spain_Spa_Cav_Lancer_Guerilla_Lanceros_Guerilla"	"Cav_Lancer_Spanish_Guerilla_Lanceros_Guerrilla"
"Britain_Spa_Cav_Lancer_Lanceros_de_Castilla_Guerrilla"	"spa_britain"	"Spain_Spa_Cav_Lancer_Lanceros_de_Castilla_Guerrilla"	"Cav_Lancer_Spanish_Lanceros_de_Castilla_Guerrilla"
"Spain_Spa_Cav_Lancer_Lanceros_de_Castilla_Guerrilla"	"spa_spain"	"Spain_Spa_Cav_Lancer_Lanceros_de_Castilla_Guerrilla"	"Cav_Lancer_Spanish_Lanceros_de_Castilla_Guerrilla"
"Britain_Spa_Cav_Lancer_Lanceros_del_Tietar_Guerrilla"	"spa_britain"	"Spain_Spa_Cav_Lancer_Lanceros_del_Tietar_Guerrilla"	"Cav_Lancer_Spanish_Lanceros_del_Tietar_Guerrilla"
"Spain_Spa_Cav_Lancer_Lanceros_del_Tietar_Guerrilla"	"spa_spain"	"Spain_Spa_Cav_Lancer_Lanceros_del_Tietar_Guerrilla"	"Cav_Lancer_Spanish_Lanceros_del_Tietar_Guerrilla"
"Prussia_Cav_Light_Prussian_Luetzows_Freicorps"	"prussia"	"Prussia_Cav_Light_Prussian_Luetzows_Freicorps"	"Cav_Light_Prussian_Luetzows_Freicorps"
"Prussia_Cav_Light_Prussian_Life_Hussars"	"prussia"	"Prussia_Cav_Light_Prussian_Life_Hussars"	"Cav_Light_Prussian_Life_Hussars"
"Portugal_Spa_Cav_Lancer_Guerilla_Lanceros_Guerilla"	"spa_portugal"	"Spain_Spa_Cav_Lancer_Guerilla_Lanceros_Guerilla"	"Cav_Lancer_Spanish_Guerilla_Lanceros_Guerrilla"
"Portugal_Spa_Cav_Lancer_Lanceros_de_Castilla_Guerrilla"	"spa_portugal"	"Spain_Spa_Cav_Lancer_Lanceros_de_Castilla_Guerrilla"	"Cav_Lancer_Spanish_Lanceros_de_Castilla_Guerrilla"
"Portugal_Spa_Cav_Lancer_Lanceros_del_Tietar_Guerrilla"	"spa_portugal"	"Spain_Spa_Cav_Lancer_Lanceros_del_Tietar_Guerrilla"	"Cav_Lancer_Spanish_Lanceros_del_Tietar_Guerrilla"
"Portugal_Spa_Cav_Light_Guerilla_Husares_Guerilla"	"spa_portugal"	"Spain_Spa_Cav_Light_Guerilla_Husares_Guerilla"	"Cav_Light_Spanish_Guerilla_Husares_Guerrilla"
"Portugal_Spa_Cav_Light_Husares_Burgos_Guerilla"	"spa_portugal"	"Spain_Spa_Cav_Light_Husares_Burgos_Guerilla"	"Cav_Light_Spanish_Husares_Burgos_Guerrilla"
"Portugal_Spa_Cav_Light_Husares_de_Cantabria_Guerrilla"	"spa_portugal"	"Spain_Spa_Cav_Light_Husares_de_Cantabria_Guerrilla"	"Cav_Light_Spanish_Husares_de_Cantabria_Guerrilla"
"Portugal_Spa_Cav_Light_Husares_de_Rioja_Guerrilla"	"spa_portugal"	"Spain_Spa_Cav_Light_Husares_de_Rioja_Guerrilla"	"Cav_Light_Spanish_Husares_de_Rioja_Guerrilla"
"Portugal_Spa_Cav_Light_Husares_de_Valpenas_Guerilla"	"spa_portugal"	"Spain_Spa_Cav_Light_Husares_de_Valpenas_Guerilla"	"Cav_Light_Spanish_Husares_de_Valpenas_Guerrilla"
"Portugal_Spa_Cav_Light_Husares_Extremadura_Guerilla"	"spa_portugal"	"Spain_Spa_Cav_Light_Husares_Extremadura_Guerilla"	"Cav_Light_Spanish_Husares_Extremadura_Guerrilla"
"Portugal_Spa_Cav_Light_Husares_Numantinos_Guerilla"	"spa_portugal"	"Spain_Spa_Cav_Light_Husares_Numantinos_Guerilla"	"Cav_Light_Spanish_Husares_Numantinos_Guerrilla"
"Portugal_Spa_Cav_Stand_Voluntarios_Ciudad_Guerrilla"	"spa_portugal"	"Spain_Spa_Cav_Stand_Voluntarios_Ciudad_Guerrilla"	"Cav_Stand_Spanish_Voluntarios_Ciudad_Guerrilla"
"Portugal_Spa_Inf_Irreg_Corso_Terrestre_Guerrilla"	"spa_portugal"	"Spain_Spa_Inf_Irreg_Corso_Terrestre_Guerrilla"	"Inf_Irreg_Spanish_Corso_Terrestre_Guerrilla"
"Portugal_Spa_Inf_Light_Cazadores_de_Cataluna_Guerrilla"	"spa_portugal"	"Spain_Spa_Inf_Light_Cazadores_de_Cataluna_Guerrilla"	"Inf_Light_Spanish_Cazadores_de_Cataluna_Guerrilla"
"Portugal_Spa_Inf_Light_Cazadores_Numantinos_Guerrilla"	"spa_portugal"	"Spain_Spa_Inf_Light_Cazadores_Numantinos_Guerrilla"	"Inf_Light_Spanish_Cazadores_Numantinos_Guerrilla"
"Portugal_Spa_Inf_Light_Guerilla_Cazadores_Guerilla"	"spa_portugal"	"Spain_Spa_Inf_Light_Guerilla_Cazadores_Guerilla"	"Inf_Light_Spanish_Guerilla_Cazadores_Guerrilla"
"Portugal_Spa_Inf_Light_Regimento_de_Arlanza_Guerrilla"	"spa_portugal"	"Spain_Spa_Inf_Light_Regimento_de_Arlanza_Guerrilla"	"Inf_Light_Spanish_Regimento_de_Arlanza_Guerrilla"
"Portugal_Spa_Inf_Line_Voluntarios_de_Coruna_Guerilla"	"spa_portugal"	"Spain_Spa_Inf_Line_Voluntarios_de_Coruna_Guerilla"	"Inf_Line_Spanish_Voluntarios_de_Coruna_Guerrilla"
"Portugal_Spa_Inf_Line_Voluntarios_Tietar_Guerrilla"	"spa_portugal"	"Spain_Spa_Inf_Line_Voluntarios_Tietar_Guerrilla"	"Inf_Line_Spanish_Voluntarios_Tietar_Guerrilla"
"Portugal_Spa_Inf_Skirm_Guerilla_Tiradores_Guerilla"	"spa_portugal"	"Spain_Spa_Inf_Skirm_Guerilla_Tiradores_Guerilla"	"Inf_Skirm_Spanish_Guerilla_Tiradores_Guerrilla"
"Portugal_Spa_Inf_Skirm_Tiradores_de_Cantabria_Guerrilla"	"spa_portugal"	"Spain_Spa_Inf_Skirm_Tiradores_de_Cantabria_Guerrilla"	"Inf_Skirm_Spanish_Tiradores_de_Cantabria_Guerrilla"
"Portugal_Spa_Mounted_Inf_Voluntarios_Madrid_Guerilla"	"spa_portugal"	"Spain_Spa_Mounted_Inf_Voluntarios_Madrid_Guerilla"	"Mounted_Inf_Spanish_Voluntarios_Madrid_Guerrilla"
"Spain_Spa_Gen_Francisco_Castanos"	"spa_spain"	"Spain_Spa_Gen_Francisco_Castanos"	"Gen_Francisco_Castanos"
"Spain_Spa_Gen_Gregorio_Garcia_de_la_Cuesta"	"spa_spain"	"Spain_Spa_Gen_Gregorio_Garcia_de_la_Cuesta"	"Gen_Gregorio_Garcia_de_la_Cuesta"
"Spain_Spa_Gen_Joaquin_Blake_y_Joyes"	"spa_spain"	"Spain_Spa_Gen_Joaquin_Blake_y_Joyes"	"Gen_Joaquin_Blake_y_Joyes"
"Spain_Spa_Gen_Guerilla_Leader_Guerilla"	"spa_spain"	"Spain_Spa_Gen_Guerilla_Leader_Guerrilla"	"Gen_British_Guerilla_Leader_Guerrilla"
"Portugal_Spa_Gen_Guerilla_Leader_Guerilla"	"spa_portugal"	"Spain_Spa_Gen_Guerilla_Leader_Guerrilla"	"Gen_British_Guerilla_Leader_Guerrilla"
"Bedouin_Inf_Irreg_Ottoman_Bashi_Bazouks"	"egy_bedouin"	"Bedouin_Inf_Irreg_Ottoman_Bashi_Bazouks"	"Inf_Irreg_Ottoman_Bashi_Bazouks"
"Portuguese_Rebels_Art_Foot_12_lber"	"portugese_rebels"	"Portuguese_Rebels_Art_Foot_12_lber"	"Art_Foot_12_lber"
"Portuguese_Rebels_Art_Foot_6_lber"	"portugese_rebels"	"Portuguese_Rebels_Art_Foot_6_lber"	"Art_Foot_6_lber"
"Portuguese_Rebels_Cav_Light_Light_Dragoons"	"portugese_rebels"	"Portuguese_Rebels_Cav_Light_Light_Dragoons"	"Cav_Light_Light_Dragoons"
"Portuguese_Rebels_Gen_Generals_Staff"	"portugese_rebels"	"Portuguese_Rebels_Gen_Generals_Staff"	"Gen_Generals_Staff"
"Portuguese_Rebels_Inf_Light_Light_Infantry"	"portugese_rebels"	"Portuguese_Rebels_Inf_Light_Light_Infantry"	"Inf_Light_Light_Infantry"
"Portuguese_Rebels_Inf_Line_Line_Infantry"	"portugese_rebels"	"Portuguese_Rebels_Inf_Line_Line_Infantry"	"Inf_Line_Line_Infantry"
"Portuguese_Rebels_Inf_Mob_Portuguese_Ordenza"	"portugese_rebels"	"Portuguese_Rebels_Inf_Mob_Portuguese_Ordenza"	"Inf_Mob_Portuguese_Ordenza"
"Portuguese_Rebels_Inf_Militia_Militia"	"portugese_rebels"	"Portuguese_Rebels_Inf_Militia_Militia"	"Inf_Militia_Militia"
"Britain_Spa_Cav_Light_British_10th_Hussars"	"spa_britain"	"Britain_Spa_Cav_Light_British_10th_Hussars"	"Cav_Light_British_10th_Hussars"
"Britain_Cav_Light_British_10th_Hussars"	"britain"	"Britain_Cav_Light_British_10th_Hussars"	"Cav_Light_British_10th_Hussars"
"Austria_Cav_Heavy_Austrian_Archduke_Ferdinand_Cuirassiers"	"austria"	"Austria_Cav_Heavy_Austrian_Archduke_Ferdinand_Cuirassiers"	"Cav_Heavy_Austrian_Archduke_Ferdinand_Cuirassiers"
"Russia_Cav_Lancer_Russian_Lifeguard_Cossacks"	"russia"	"Russia_Cav_Lancer_Russian_Lifeguard_Cossacks"	"Cav_Lancer_Russian_Lifeguard_Cossacks"
