version 1, schema warscape_rigid_tables
Filename_x0020_WR_ID(string)	Texture_path(string)	Category(string)
"64lb_gun_model_destructed_model"	"EngineModels/Textures"	"battle_misc"
"agent_ID_afghanistan"	"RigidModels/CampaignBuildings/CampaignAgentIcons/Textures"	"campaign_template_extra"
"agent_ID_austria"	"RigidModels/CampaignBuildings/CampaignAgentIcons/Textures"	"campaign_template_extra"
"agent_ID_austria_republic"	"RigidModels/CampaignBuildings/CampaignAgentIcons/Textures"	"campaign_template_extra"
"agent_ID_barbary_republic"	"RigidModels/CampaignBuildings/CampaignAgentIcons/Textures"	"campaign_template_extra"
"agent_ID_barbary_states"	"RigidModels/CampaignBuildings/CampaignAgentIcons/Textures"	"campaign_template_extra"
"agent_ID_bavaria"	"RigidModels/CampaignBuildings/CampaignAgentIcons/Textures"	"campaign_template_extra"
"agent_ID_britain"	"RigidModels/CampaignBuildings/CampaignAgentIcons/Textures"	"campaign_template_extra"
"agent_ID_british_republic"	"RigidModels/CampaignBuildings/CampaignAgentIcons/Textures"	"campaign_template_extra"
"agent_ID_chechenya_dagestan"	"RigidModels/CampaignBuildings/CampaignAgentIcons/Textures"	"campaign_template_extra"
"agent_ID_cherokee"	"RigidModels/CampaignBuildings/CampaignAgentIcons/Textures"	"campaign_template_extra"
"agent_ID_courland"	"RigidModels/CampaignBuildings/CampaignAgentIcons/Textures"	"campaign_template_extra"
"agent_ID_crimean_khanate"	"RigidModels/CampaignBuildings/CampaignAgentIcons/Textures"	"campaign_template_extra"
"agent_ID_denmark"	"RigidModels/CampaignBuildings/CampaignAgentIcons/Textures"	"campaign_template_extra"
"agent_ID_denmark_republic"	"RigidModels/CampaignBuildings/CampaignAgentIcons/Textures"	"campaign_template_extra"
"agent_ID_france"	"RigidModels/CampaignBuildings/CampaignAgentIcons/Textures"	"campaign_template_extra"
"agent_ID_france_republic"	"RigidModels/CampaignBuildings/CampaignAgentIcons/Textures"	"campaign_template_extra"
"agent_ID_genoa"	"RigidModels/CampaignBuildings/CampaignAgentIcons/Textures"	"campaign_template_extra"
"agent_ID_georgia"	"RigidModels/CampaignBuildings/CampaignAgentIcons/Textures"	"campaign_template_extra"
"agent_ID_greece"	"RigidModels/CampaignBuildings/CampaignAgentIcons/Textures"	"campaign_template_extra"
"agent_ID_hannover"	"RigidModels/CampaignBuildings/CampaignAgentIcons/Textures"	"campaign_template_extra"
"agent_ID_hessen"	"RigidModels/CampaignBuildings/CampaignAgentIcons/Textures"	"campaign_template_extra"
"agent_ID_holstein_gottorp"	"RigidModels/CampaignBuildings/CampaignAgentIcons/Textures"	"campaign_template_extra"
"agent_ID_hungary"	"RigidModels/CampaignBuildings/CampaignAgentIcons/Textures"	"campaign_template_extra"
"agent_ID_huron"	"RigidModels/CampaignBuildings/CampaignAgentIcons/Textures"	"campaign_template_extra"
"agent_ID_inuit"	"RigidModels/CampaignBuildings/CampaignAgentIcons/Textures"	"campaign_template_extra"
"agent_ID_ireland"	"RigidModels/CampaignBuildings/CampaignAgentIcons/Textures"	"campaign_template_extra"
"agent_ID_iroquois"	"RigidModels/CampaignBuildings/CampaignAgentIcons/Textures"	"campaign_template_extra"
"agent_ID_knanate_khiva"	"RigidModels/CampaignBuildings/CampaignAgentIcons/Textures"	"campaign_template_extra"
"agent_ID_knights_stjohn"	"RigidModels/CampaignBuildings/CampaignAgentIcons/Textures"	"campaign_template_extra"
"agent_ID_louisiana"	"RigidModels/CampaignBuildings/CampaignAgentIcons/Textures"	"campaign_template_extra"
"agent_ID_malta"	"RigidModels/CampaignBuildings/CampaignAgentIcons/Textures"	"campaign_template_extra"
"agent_ID_mamelukes"	"RigidModels/CampaignBuildings/CampaignAgentIcons/Textures"	"campaign_template_extra"
"agent_ID_maratha"	"RigidModels/CampaignBuildings/CampaignAgentIcons/Textures"	"campaign_template_extra"
"agent_ID_maratha_republic"	"RigidModels/CampaignBuildings/CampaignAgentIcons/Textures"	"campaign_template_extra"
"agent_ID_mecklenburg"	"RigidModels/CampaignBuildings/CampaignAgentIcons/Textures"	"campaign_template_extra"
"agent_ID_morocco"	"RigidModels/CampaignBuildings/CampaignAgentIcons/Textures"	"campaign_template_extra"
"agent_ID_mughal"	"RigidModels/CampaignBuildings/CampaignAgentIcons/Textures"	"campaign_template_extra"
"agent_ID_mughal_republic"	"RigidModels/CampaignBuildings/CampaignAgentIcons/Textures"	"campaign_template_extra"
"agent_ID_mysore"	"RigidModels/CampaignBuildings/CampaignAgentIcons/Textures"	"campaign_template_extra"
"agent_ID_naples_sicily"	"RigidModels/CampaignBuildings/CampaignAgentIcons/Textures"	"campaign_template_extra"
"agent_ID_netherlands"	"RigidModels/CampaignBuildings/CampaignAgentIcons/Textures"	"campaign_template_extra"
"agent_ID_netherlands_republic"	"RigidModels/CampaignBuildings/CampaignAgentIcons/Textures"	"campaign_template_extra"
"agent_ID_netherlands_revolutionary"	"RigidModels/CampaignBuildings/CampaignAgentIcons/Textures"	"campaign_template_extra"
"agent_ID_new_spain"	"RigidModels/CampaignBuildings/CampaignAgentIcons/Textures"	"campaign_template_extra"
"agent_ID_norway"	"RigidModels/CampaignBuildings/CampaignAgentIcons/Textures"	"campaign_template_extra"
"agent_ID_ottomans"	"RigidModels/CampaignBuildings/CampaignAgentIcons/Textures"	"campaign_template_extra"
"agent_ID_papal_states"	"RigidModels/CampaignBuildings/CampaignAgentIcons/Textures"	"campaign_template_extra"
"agent_ID_piedmont_savoy"	"RigidModels/CampaignBuildings/CampaignAgentIcons/Textures"	"campaign_template_extra"
"agent_ID_pirates"	"RigidModels/CampaignBuildings/CampaignAgentIcons/Textures"	"campaign_template_extra"
"agent_ID_plains"	"RigidModels/CampaignBuildings/CampaignAgentIcons/Textures"	"campaign_template_extra"
"agent_ID_poland_lithuania"	"RigidModels/CampaignBuildings/CampaignAgentIcons/Textures"	"campaign_template_extra"
"agent_ID_poland_republic"	"RigidModels/CampaignBuildings/CampaignAgentIcons/Textures"	"campaign_template_extra"
"agent_ID_portugal"	"RigidModels/CampaignBuildings/CampaignAgentIcons/Textures"	"campaign_template_extra"
"agent_ID_prussia"	"RigidModels/CampaignBuildings/CampaignAgentIcons/Textures"	"campaign_template_extra"
"agent_ID_prussia_republic"	"RigidModels/CampaignBuildings/CampaignAgentIcons/Textures"	"campaign_template_extra"
"agent_ID_pueblo"	"RigidModels/CampaignBuildings/CampaignAgentIcons/Textures"	"campaign_template_extra"
"agent_ID_punjab"	"RigidModels/CampaignBuildings/CampaignAgentIcons/Textures"	"campaign_template_extra"
"agent_ID_rebels"	"RigidModels/CampaignBuildings/CampaignAgentIcons/Textures"	"campaign_template_extra"
"agent_ID_rebels_eastern"	"RigidModels/CampaignBuildings/CampaignAgentIcons/Textures"	"campaign_template_extra"
"agent_ID_rebels_other"	"RigidModels/CampaignBuildings/CampaignAgentIcons/Textures"	"campaign_template_extra"
"agent_ID_rebels_western"	"RigidModels/CampaignBuildings/CampaignAgentIcons/Textures"	"campaign_template_extra"
"agent_ID_russia"	"RigidModels/CampaignBuildings/CampaignAgentIcons/Textures"	"campaign_template_extra"
"agent_ID_russia_republic"	"RigidModels/CampaignBuildings/CampaignAgentIcons/Textures"	"campaign_template_extra"
"agent_ID_safavids"	"RigidModels/CampaignBuildings/CampaignAgentIcons/Textures"	"campaign_template_extra"
"agent_ID_saxony"	"RigidModels/CampaignBuildings/CampaignAgentIcons/Textures"	"campaign_template_extra"
"agent_ID_scotland"	"RigidModels/CampaignBuildings/CampaignAgentIcons/Textures"	"campaign_template_extra"
"agent_ID_spain"	"RigidModels/CampaignBuildings/CampaignAgentIcons/Textures"	"campaign_template_extra"
"agent_ID_spain_republic"	"RigidModels/CampaignBuildings/CampaignAgentIcons/Textures"	"campaign_template_extra"
"agent_ID_sweden"	"RigidModels/CampaignBuildings/CampaignAgentIcons/Textures"	"campaign_template_extra"
"agent_ID_sweden_republic"	"RigidModels/CampaignBuildings/CampaignAgentIcons/Textures"	"campaign_template_extra"
"agent_ID_swiss_confederation"	"RigidModels/CampaignBuildings/CampaignAgentIcons/Textures"	"campaign_template_extra"
"agent_ID_thirteen_colonies"	"RigidModels/CampaignBuildings/CampaignAgentIcons/Textures"	"campaign_template_extra"
"agent_ID_tuscany"	"RigidModels/CampaignBuildings/CampaignAgentIcons/Textures"	"campaign_template_extra"
"agent_ID_united_states"	"RigidModels/CampaignBuildings/CampaignAgentIcons/Textures"	"campaign_template_extra"
"agent_ID_us_monarchy"	"RigidModels/CampaignBuildings/CampaignAgentIcons/Textures"	"campaign_template_extra"
"agent_ID_venice"	"RigidModels/CampaignBuildings/CampaignAgentIcons/Textures"	"campaign_template_extra"
"agent_ID_virginia"	"RigidModels/CampaignBuildings/CampaignAgentIcons/Textures"	"campaign_template_extra"
"agent_ID_virginia_colonists"	"RigidModels/CampaignBuildings/CampaignAgentIcons/Textures"	"campaign_template_extra"
"agent_ID_westphalia"	"RigidModels/CampaignBuildings/CampaignAgentIcons/Textures"	"campaign_template_extra"
"agent_ID_wurttemberg"	"RigidModels/CampaignBuildings/CampaignAgentIcons/Textures"	"campaign_template_extra"
"All_agent_indicator_assassin_enemy"	"RigidModels/CampaignBuildings/CampaignAgentIcons/Textures"	"campaign_template_extra"
"All_agent_indicator_assassin_home"	"RigidModels/CampaignBuildings/CampaignAgentIcons/Textures"	"campaign_template_extra"
"All_agent_indicator_assassin_home_enemy"	"RigidModels/CampaignBuildings/CampaignAgentIcons/Textures"	"campaign_template_extra"
"All_agent_indicator_gentleman_enemy"	"RigidModels/CampaignBuildings/CampaignAgentIcons/Textures"	"campaign_template_extra"
"All_agent_indicator_gentleman_home"	"RigidModels/CampaignBuildings/CampaignAgentIcons/Textures"	"campaign_template_extra"
"All_agent_indicator_gentleman_home_enemy"	"RigidModels/CampaignBuildings/CampaignAgentIcons/Textures"	"campaign_template_extra"
"All_agent_indicator_missionary_enemy"	"RigidModels/CampaignBuildings/CampaignAgentIcons/Textures"	"campaign_template_extra"
"All_agent_indicator_missionary_home"	"RigidModels/CampaignBuildings/CampaignAgentIcons/Textures"	"campaign_template_extra"
"All_agent_indicator_missionary_home_enemy"	"RigidModels/CampaignBuildings/CampaignAgentIcons/Textures"	"campaign_template_extra"
"All_agent_indicator_scout_enemy"	"RigidModels/CampaignBuildings/CampaignAgentIcons/Textures"	"campaign_template_extra"
"All_agent_indicator_scout_home"	"RigidModels/CampaignBuildings/CampaignAgentIcons/Textures"	"campaign_template_extra"
"All_agent_indicator_scout_home_enemy"	"RigidModels/CampaignBuildings/CampaignAgentIcons/Textures"	"campaign_template_extra"
"All_agent_indicator_shaman_enemy"	"RigidModels/CampaignBuildings/CampaignAgentIcons/Textures"	"campaign_template_extra"
"All_agent_indicator_shaman_home"	"RigidModels/CampaignBuildings/CampaignAgentIcons/Textures"	"campaign_template_extra"
"All_agent_indicator_shaman_home_enemy"	"RigidModels/CampaignBuildings/CampaignAgentIcons/Textures"	"campaign_template_extra"
"ALL_army_dug_in"	"RigidModels/CampaignBuildings/CampaignProps/Textures"	"campaign_template_extra"
"ALL_army_no_movement_points"	"RigidModels/CampaignBuildings/CampaignProps/Textures"	"campaign_template_extra"
"ALL_city_building_construction"	"RigidModels/CampaignBuildings/CampaignProps/Textures"	"campaign_template_extra"
"ALL_port_blockade"	"RigidModels/CampaignBuildings/CampaignProps/Textures"	"campaign_template_extra"
"ALL_port_construction"	"RigidModels/CampaignBuildings/CampaignProps/Textures"	"campaign_template_extra"
"ambush_buildings_marker"	"RigidModels\\WarscapeFrame\\ai_hints\\Textures"	"3Dindicators"
"ambush_forest_marker"	"RigidModels\\WarscapeFrame\\ai_hints\\Textures"	"3Dindicators"
"american_bridge_basic_piece01_destruct01"	"RigidModels\\Buildings\\AAA_TEXTURES"	"battle_building"
"american_bridge_basic_piece02_destruct01"	"RigidModels\\Buildings\\AAA_TEXTURES"	"battle_building"
"american_bridge_basic_piece02_destruct02"	"RigidModels\\Buildings\\AAA_TEXTURES"	"battle_building"
"american_bridge_refined_piece01_destruct01"	"RigidModels\\Buildings\\AAA_TEXTURES"	"battle_building"
"american_bridge_refined_piece02_destruct01"	"RigidModels\\Buildings\\AAA_TEXTURES"	"battle_building"
"american_bridge_refined_piece02_destruct02"	"RigidModels\\Buildings\\AAA_TEXTURES"	"battle_building"
"american_church_piece01_destruct01"	"RigidModels\\Buildings\\AAA_TEXTURES"	"battle_building"
"american_church_piece01_destruct02"	"RigidModels\\Buildings\\AAA_TEXTURES"	"battle_building"
"american_fence_piece01_destruct01"	"RigidModels\\Buildings\\AAA_TEXTURES"	"battle_building"
"american_fenceend_piece01_destruct01"	"RigidModels\\Buildings\\AAA_TEXTURES"	"battle_building"
"american_gaet_piece01_destruct01"	"RigidModels\\Buildings\\AAA_TEXTURES"	"battle_building"
"american_house01_piece01_destruct01"	"RigidModels\\Buildings\\AAA_TEXTURES"	"battle_building"
"american_house01_piece01_destruct02"	"RigidModels\\Buildings\\AAA_TEXTURES"	"battle_building"
"american_house01b_piece01_destruct01"	"RigidModels\\Buildings\\AAA_TEXTURES"	"battle_building"
"american_house01b_piece01_destruct02"	"RigidModels\\Buildings\\AAA_TEXTURES"	"battle_building"
"american_house02_piece01_destruct01"	"RigidModels\\Buildings\\AAA_TEXTURES"	"battle_building"
"american_house02_piece01_destruct02"	"RigidModels\\Buildings\\AAA_TEXTURES"	"battle_building"
"american_house02b_piece01_destruct01"	"RigidModels\\Buildings\\AAA_TEXTURES"	"battle_building"
"american_house02b_piece01_destruct02"	"RigidModels\\Buildings\\AAA_TEXTURES"	"battle_building"
"american_house03_piece01_destruct01"	"RigidModels\\Buildings\\AAA_TEXTURES"	"battle_building"
"american_house03_piece01_destruct02"	"RigidModels\\Buildings\\AAA_TEXTURES"	"battle_building"
"american_house03b_piece01_destruct01"	"RigidModels\\Buildings\\AAA_TEXTURES"	"battle_building"
"american_house03b_piece01_destruct02"	"RigidModels\\Buildings\\AAA_TEXTURES"	"battle_building"
"american_house04_piece01_destruct01"	"RigidModels\\Buildings\\AAA_TEXTURES"	"battle_building"
"american_house04_piece01_destruct02"	"RigidModels\\Buildings\\AAA_TEXTURES"	"battle_building"
"american_house04b_piece01_destruct01"	"RigidModels\\Buildings\\AAA_TEXTURES"	"battle_building"
"american_house04b_piece01_destruct02"	"RigidModels\\Buildings\\AAA_TEXTURES"	"battle_building"
"american_house05_piece01_destruct01"	"RigidModels\\Buildings\\AAA_TEXTURES"	"battle_building"
"american_house05_piece01_destruct02"	"RigidModels\\Buildings\\AAA_TEXTURES"	"battle_building"
"american_house05b_piece01_destruct01"	"RigidModels\\Buildings\\AAA_TEXTURES"	"battle_building"
"american_house05b_piece01_destruct02"	"RigidModels\\Buildings\\AAA_TEXTURES"	"battle_building"
"american_house06_piece01_destruct01"	"RigidModels\\Buildings\\AAA_TEXTURES"	"battle_building"
"american_house06_piece01_destruct02"	"RigidModels\\Buildings\\AAA_TEXTURES"	"battle_building"
"american_house06b_piece01_destruct01"	"RigidModels\\Buildings\\AAA_TEXTURES"	"battle_building"
"american_house06b_piece01_destruct02"	"RigidModels\\Buildings\\AAA_TEXTURES"	"battle_building"
"american_monument_piece01_destruct01"	"RigidModels\\Buildings\\AAA_TEXTURES"	"battle_building"
"american_monument_piece01_destruct02"	"RigidModels\\Buildings\\AAA_TEXTURES"	"battle_building"
"american_ruin01_piece01_destruct01"	"RigidModels\\Buildings\\AAA_TEXTURES"	"battle_building"
"american_ruin01_piece01_destruct02"	"RigidModels\\Buildings\\AAA_TEXTURES"	"battle_building"
"american_rural01_piece01_destruct01"	"RigidModels\\Buildings\\AAA_TEXTURES"	"battle_building"
"american_rural01_piece01_destruct02"	"RigidModels\\Buildings\\AAA_TEXTURES"	"battle_building"
"american_rural01b_piece01_destruct01"	"RigidModels\\Buildings\\AAA_TEXTURES"	"battle_building"
"american_rural01b_piece01_destruct02"	"RigidModels\\Buildings\\AAA_TEXTURES"	"battle_building"
"american_rural02_piece01_destruct01"	"RigidModels\\Buildings\\AAA_TEXTURES"	"battle_building"
"american_rural02_piece01_destruct02"	"RigidModels\\Buildings\\AAA_TEXTURES"	"battle_building"
"american_rural02b_piece01_destruct01"	"RigidModels\\Buildings\\AAA_TEXTURES"	"battle_building"
"american_rural02b_piece01_destruct02"	"RigidModels\\Buildings\\AAA_TEXTURES"	"battle_building"
"american_rural03_piece01_destruct01"	"RigidModels\\Buildings\\AAA_TEXTURES"	"battle_building"
"american_rural03_piece01_destruct02"	"RigidModels\\Buildings\\AAA_TEXTURES"	"battle_building"
"american_rural03b_piece01_destruct01"	"RigidModels\\Buildings\\AAA_TEXTURES"	"battle_building"
"american_rural03b_piece01_destruct02"	"RigidModels\\Buildings\\AAA_TEXTURES"	"battle_building"
"american_stile_piece01_destruct01"	"RigidModels\\Buildings\\AAA_TEXTURES"	"battle_building"
"american_townhall_piece01_destruct01"	"RigidModels\\Buildings\\AAA_TEXTURES"	"battle_building"
"american_townhall_piece01_destruct02"	"RigidModels\\Buildings\\AAA_TEXTURES"	"battle_building"
"american_townhall_piece01_destruct03"	"RigidModels\\Buildings\\AAA_TEXTURES"	"battle_building"
"american_warehouse_piece01_destruct01"	"RigidModels\\Buildings\\AAA_TEXTURES"	"battle_building"
"american_warehouse_piece01_destruct02"	"RigidModels\\Buildings\\AAA_TEXTURES"	"battle_building"
"Ammo_Caisson_destructed"	"EngineModels/Textures"	"battle_misc"
"ancient_field_cannon_24lb_model_destructed_model"	"EngineModels/Textures"	"battle_misc"
"ancient_field_cannon_9lb_model_destructed_model"	"EngineModels/Textures"	"battle_misc"
"arrow"	"RigidModels/Projectile/Textures"	"projectiles"
"arrows_eu"	"RigidModels\\CampaignBuildings\\CampaignProps\\Textures"	"campaign_building"
"arrows_india"	"RigidModels\\CampaignBuildings\\CampaignProps\\Textures"	"campaign_building"
"arrows_usa"	"RigidModels\\CampaignBuildings\\CampaignProps\\Textures"	"campaign_building"
"artillery_proxy"	"RigidModels\\3DIndicators\\Textures"	"3Dindicators"
"boarding_plank"	"RigidModels/Naval/Textures"	"battle_misc"
"boulder_collection_1_piece01_destruct01"	"RigidModels\\Buildings\\AAA_TEXTURES"	"battle_building"
"boulder_collection_2_piece01_destruct01"	"RigidModels\\Buildings\\AAA_TEXTURES"	"battle_building"
"boulder_collection_3_piece01_destruct01"	"RigidModels\\Buildings\\AAA_TEXTURES"	"battle_building"
"boulder_collection_4_piece01_destruct01"	"RigidModels\\Buildings\\AAA_TEXTURES"	"battle_building"
"boulder_collection_5_piece01_destruct01"	"RigidModels\\Buildings\\AAA_TEXTURES"	"battle_building"
"boulder_collection_6_piece01_destruct01"	"RigidModels\\Buildings\\AAA_TEXTURES"	"battle_building"
"boulder_collection_small_1_piece01_destruct01"	"RigidModels\\Buildings\\AAA_TEXTURES"	"battle_building"
"boulder_collection_small_2_piece01_destruct01"	"RigidModels\\Buildings\\AAA_TEXTURES"	"battle_building"
"boulder_collection_small_3_piece01_destruct01"	"RigidModels\\Buildings\\AAA_TEXTURES"	"battle_building"
"boulder_collection_small_4_piece01_destruct01"	"RigidModels\\Buildings\\AAA_TEXTURES"	"battle_building"
"boulder_collection_small_5_piece01_destruct01"	"RigidModels\\Buildings\\AAA_TEXTURES"	"battle_building"
"boulder_collection_small_6_piece01_destruct01"	"RigidModels\\Buildings\\AAA_TEXTURES"	"battle_building"
"campaign_bridge_dirt"	"RigidModels/CampaignBridges/Textures"	"campaign_building"
"campaign_bridge_primitive"	"RigidModels/CampaignBridges/Textures"	"campaign_building"
"campaign_bridge_stone"	"RigidModels/CampaignBridges/Textures"	"campaign_building"
"campaign_bridge_tarmac"	"RigidModels/CampaignBridges/Textures"	"campaign_building"
"Campaign_building_damage_smoke"	"RigidModels/CampaignBuildings/CampaignProps/Textures"	"campaign_building"
"campaign_city_5slot_siege"	"RigidModels/CampaignBuildings/SiegeModels/Textures"	"campaign_template_extra"
"cannon_muzzle01"	"RigidModels/Projectile/Textures"	"projectiles"
"capture_zone_marker"	"RigidModels/VerletItems/textures"	"battle_misc"
"carronade_destroyed"	"EngineModels/Textures"	"battle_misc"
"cavalry_proxy"	"RigidModels\\3DIndicators\\Textures"	"3Dindicators"
"choke_point_marker"	"RigidModels\\WarscapeFrame\\ai_hints\\Textures"	"3Dindicators"
"city_east_building_01"	"RigidModels\\city_buildings\\east\\textures"	"battle_building"
"city_east_building_02"	"RigidModels\\city_buildings\\east\\textures"	"battle_building"
"city_east_building_03"	"RigidModels\\city_buildings\\east\\textures"	"battle_building"
"city_east_building_04"	"RigidModels\\city_buildings\\east\\textures"	"battle_building"
"city_east_building_05"	"RigidModels\\city_buildings\\east\\textures"	"battle_building"
"city_east_building_06"	"RigidModels\\city_buildings\\east\\textures"	"battle_building"
"city_east_building_07"	"RigidModels\\city_buildings\\east\\textures"	"battle_building"
"city_east_church"	"RigidModels\\city_buildings\\east\\textures"	"battle_building"
"city_east_townhall"	"RigidModels\\city_buildings\\east\\textures"	"battle_building"
"city_euro_building_01"	"RigidModels\\city_buildings\\euro\\textures"	"battle_building"
"city_euro_building_02"	"RigidModels\\city_buildings\\euro\\textures"	"battle_building"
"city_euro_building_03"	"RigidModels\\city_buildings\\euro\\textures"	"battle_building"
"city_euro_building_04"	"RigidModels\\city_buildings\\euro\\textures"	"battle_building"
"city_euro_building_05"	"RigidModels\\city_buildings\\euro\\textures"	"battle_building"
"city_euro_building_06"	"RigidModels\\city_buildings\\euro\\textures"	"battle_building"
"city_euro_building_07"	"RigidModels\\city_buildings\\euro\\textures"	"battle_building"
"city_euro_church"	"RigidModels\\city_buildings\\euro\\textures"	"battle_building"
"city_euro_townhall"	"RigidModels\\city_buildings\\euro\\textures"	"battle_building"
"city_native_building_01"	"RigidModels\\city_buildings\\native\\textures"	"battle_building"
"city_native_building_02"	"RigidModels\\city_buildings\\native\\textures"	"battle_building"
"city_native_building_03"	"RigidModels\\city_buildings\\native\\textures"	"battle_building"
"city_native_church"	"RigidModels\\city_buildings\\native\\textures"	"battle_building"
"city_native_townhall"	"RigidModels\\city_buildings\\native\\textures"	"battle_building"
"city_us_building_01"	"RigidModels\\city_buildings\\us\\textures"	"battle_building"
"city_us_building_02"	"RigidModels\\city_buildings\\us\\textures"	"battle_building"
"city_us_building_03"	"RigidModels\\city_buildings\\us\\textures"	"battle_building"
"city_us_building_04"	"RigidModels\\city_buildings\\us\\textures"	"battle_building"
"city_us_building_05"	"RigidModels\\city_buildings\\us\\textures"	"battle_building"
"city_us_building_06"	"RigidModels\\city_buildings\\us\\textures"	"battle_building"
"city_us_building_07"	"RigidModels\\city_buildings\\us\\textures"	"battle_building"
"city_us_church"	"RigidModels\\city_buildings\\us\\textures"	"battle_building"
"city_us_townhall"	"RigidModels\\city_buildings\\us\\textures"	"battle_building"
"coast_sound_emitter_marker"	"RigidModels\\WarscapeFrame\\sound_emitters\\textures"	"3Dindicators"
"cover_marker"	"RigidModels\\WarscapeFrame\\ai_hints\\Textures"	"3Dindicators"
"dead_ground_marker"	"RigidModels\\WarscapeFrame\\ai_hints\\Textures"	"3Dindicators"
"defensive_line_marker"	"RigidModels\\WarscapeFrame\\ai_hints\\Textures"	"3Dindicators"
"deployable_item_chevaux_de_frise"	"RigidModels/DeployableItems/cheval_de_frise/Textures"	"battle_misc"
"deployable_item_earthworks"	"RigidModels/DeployableItems/earthworks/Textures"	"battle_misc"
"deployable_item_fougasse"	"RigidModels/DeployableItems/fougasse/Textures"	"battle_misc"
"deployable_item_gabionade_center_piece"	"RigidModels/DeployableItems/gabionade/Textures"	"battle_misc"
"deployable_item_gabionade_left_piece"	"RigidModels/DeployableItems/gabionade/Textures"	"battle_misc"
"deployable_item_gabionade_right_piece"	"RigidModels/DeployableItems/gabionade/Textures"	"battle_misc"
"deployable_item_wooden_stake"	"UnitModels/Textures"	"battle_misc"
"destination_marker"	"RigidModels/3DIndicators/Textures"	"3DIndicators"
"east_euro_church_piece01_destruct01"	"RigidModels\\Buildings\\AAA_TEXTURES"	"battle_building"
"east_euro_church_piece01_destruct02"	"RigidModels\\Buildings\\AAA_TEXTURES"	"battle_building"
"east_euro_farmhouse_piece01_destruct01"	"RigidModels\\Buildings\\AAA_TEXTURES"	"battle_building"
"east_euro_farmhouse_piece01_destruct02"	"RigidModels\\Buildings\\AAA_TEXTURES"	"battle_building"
"east_euro_farmhouse_piece01_destruct03"	"RigidModels\\Buildings\\AAA_TEXTURES"	"battle_building"
"east_euro_house01_piece01_destruct01"	"RigidModels\\Buildings\\AAA_TEXTURES"	"battle_building"
"east_euro_house01_piece01_destruct02"	"RigidModels\\Buildings\\AAA_TEXTURES"	"battle_building"
"east_euro_house01b_piece01_destruct01"	"RigidModels\\Buildings\\AAA_TEXTURES"	"battle_building"
"east_euro_house01b_piece01_destruct02"	"RigidModels\\Buildings\\AAA_TEXTURES"	"battle_building"
"east_euro_house02_piece01_destruct01"	"RigidModels\\Buildings\\AAA_TEXTURES"	"battle_building"
"east_euro_house02_piece01_destruct02"	"RigidModels\\Buildings\\AAA_TEXTURES"	"battle_building"
"east_euro_house02b_piece01_destruct01"	"RigidModels\\Buildings\\AAA_TEXTURES"	"battle_building"
"east_euro_house02b_piece01_destruct02"	"RigidModels\\Buildings\\AAA_TEXTURES"	"battle_building"
"east_euro_house03_piece01_destruct01"	"RigidModels\\Buildings\\AAA_TEXTURES"	"battle_building"
"east_euro_house03_piece01_destruct02"	"RigidModels\\Buildings\\AAA_TEXTURES"	"battle_building"
"east_euro_house03b_piece01_destruct01"	"RigidModels\\Buildings\\AAA_TEXTURES"	"battle_building"
"east_euro_house03b_piece01_destruct02"	"RigidModels\\Buildings\\AAA_TEXTURES"	"battle_building"
"east_euro_house04_piece01_destruct01"	"RigidModels\\Buildings\\AAA_TEXTURES"	"battle_building"
"east_euro_house04_piece01_destruct02"	"RigidModels\\Buildings\\AAA_TEXTURES"	"battle_building"
"east_euro_house04b_piece01_destruct01"	"RigidModels\\Buildings\\AAA_TEXTURES"	"battle_building"
"east_euro_house04b_piece01_destruct02"	"RigidModels\\Buildings\\AAA_TEXTURES"	"battle_building"
"east_euro_house05_piece01_destruct01"	"RigidModels\\Buildings\\AAA_TEXTURES"	"battle_building"
"east_euro_house05_piece01_destruct02"	"RigidModels\\Buildings\\AAA_TEXTURES"	"battle_building"
"east_euro_house05b_piece01_destruct01"	"RigidModels\\Buildings\\AAA_TEXTURES"	"battle_building"
"east_euro_house05b_piece01_destruct02"	"RigidModels\\Buildings\\AAA_TEXTURES"	"battle_building"
"east_euro_house06_piece01_destruct01"	"RigidModels\\Buildings\\AAA_TEXTURES"	"battle_building"
"east_euro_house06_piece01_destruct02"	"RigidModels\\Buildings\\AAA_TEXTURES"	"battle_building"
"east_euro_house06b_piece01_destruct01"	"RigidModels\\Buildings\\AAA_TEXTURES"	"battle_building"
"east_euro_house06b_piece01_destruct02"	"RigidModels\\Buildings\\AAA_TEXTURES"	"battle_building"
"east_euro_house07_piece01_destruct01"	"RigidModels\\Buildings\\AAA_TEXTURES"	"battle_building"
"east_euro_house07_piece01_destruct02"	"RigidModels\\Buildings\\AAA_TEXTURES"	"battle_building"
"east_euro_house07b_piece01_destruct01"	"RigidModels\\Buildings\\AAA_TEXTURES"	"battle_building"
"east_euro_house07b_piece01_destruct02"	"RigidModels\\Buildings\\AAA_TEXTURES"	"battle_building"
"east_euro_house08_piece01_destruct01"	"RigidModels\\Buildings\\AAA_TEXTURES"	"battle_building"
"east_euro_house08_piece01_destruct02"	"RigidModels\\Buildings\\AAA_TEXTURES"	"battle_building"
"east_euro_house08b_piece01_destruct01"	"RigidModels\\Buildings\\AAA_TEXTURES"	"battle_building"
"east_euro_house08b_piece01_destruct02"	"RigidModels\\Buildings\\AAA_TEXTURES"	"battle_building"
"east_euro_house09_piece01_destruct01"	"RigidModels\\Buildings\\AAA_TEXTURES"	"battle_building"
"east_euro_house09_piece01_destruct02"	"RigidModels\\Buildings\\AAA_TEXTURES"	"battle_building"
"east_euro_house09b_piece01_destruct01"	"RigidModels\\Buildings\\AAA_TEXTURES"	"battle_building"
"east_euro_house09b_piece01_destruct02"	"RigidModels\\Buildings\\AAA_TEXTURES"	"battle_building"
"east_euro_hut01_piece01_destruct01"	"RigidModels\\Buildings\\AAA_TEXTURES"	"battle_building"
"east_euro_hut01_piece01_destruct02"	"RigidModels\\Buildings\\AAA_TEXTURES"	"battle_building"
"east_euro_hut02_piece01_destruct01"	"RigidModels\\Buildings\\AAA_TEXTURES"	"battle_building"
"east_euro_hut02_piece01_destruct02"	"RigidModels\\Buildings\\AAA_TEXTURES"	"battle_building"
"east_euro_hut03_piece01_destruct01"	"RigidModels\\Buildings\\AAA_TEXTURES"	"battle_building"
"east_euro_hut03_piece01_destruct02"	"RigidModels\\Buildings\\AAA_TEXTURES"	"battle_building"
"east_euro_hut04_piece01_destruct01"	"RigidModels\\Buildings\\AAA_TEXTURES"	"battle_building"
"east_euro_hut04_piece01_destruct02"	"RigidModels\\Buildings\\AAA_TEXTURES"	"battle_building"
"east_euro_hut05_piece01_destruct01"	"RigidModels\\Buildings\\AAA_TEXTURES"	"battle_building"
"east_euro_hut05_piece01_destruct02"	"RigidModels\\Buildings\\AAA_TEXTURES"	"battle_building"
"east_euro_monument_piece01_destruct01"	"RigidModels\\Buildings\\AAA_TEXTURES"	"battle_building"
"east_euro_monument_piece01_destruct02"	"RigidModels\\Buildings\\AAA_TEXTURES"	"battle_building"
"east_euro_ruins_piece01_destruct01"	"RigidModels\\Buildings\\AAA_TEXTURES"	"battle_building"
"east_euro_rural01_piece01_destruct01"	"RigidModels\\Buildings\\AAA_TEXTURES"	"battle_building"
"east_euro_rural01_piece01_destruct02"	"RigidModels\\Buildings\\AAA_TEXTURES"	"battle_building"
"east_euro_rural02_piece01_destruct01"	"RigidModels\\Buildings\\AAA_TEXTURES"	"battle_building"
"east_euro_rural02_piece01_destruct02"	"RigidModels\\Buildings\\AAA_TEXTURES"	"battle_building"
"east_euro_rural03_piece01_destruct01"	"RigidModels\\Buildings\\AAA_TEXTURES"	"battle_building"
"east_euro_rural03_piece01_destruct02"	"RigidModels\\Buildings\\AAA_TEXTURES"	"battle_building"
"east_euro_stone_bridge_piece01_destruct01"	"RigidModels\\Buildings\\AAA_TEXTURES"	"battle_building"
"east_euro_stone_bridge_piece02_destruct01"	"RigidModels\\Buildings\\AAA_TEXTURES"	"battle_building"
"east_euro_stone_bridge_piece02_destruct02"	"RigidModels\\Buildings\\AAA_TEXTURES"	"battle_building"
"east_euro_townhall_piece01_destruct01"	"RigidModels\\Buildings\\AAA_TEXTURES"	"battle_building"
"east_euro_townhall_piece01_destruct02"	"RigidModels\\Buildings\\AAA_TEXTURES"	"battle_building"
"east_euro_townhall_piece01_destruct03"	"RigidModels\\Buildings\\AAA_TEXTURES"	"battle_building"
"east_euro_townhall_piece02_destruct01"	"RigidModels\\Buildings\\AAA_TEXTURES"	"battle_building"
"east_euro_townhall_piece02_destruct02"	"RigidModels\\Buildings\\AAA_TEXTURES"	"battle_building"
"east_euro_townhall_piece02_destruct03"	"RigidModels\\Buildings\\AAA_TEXTURES"	"battle_building"
"east_euro_windmill_piece01_destruct01"	"RigidModels\\Buildings\\AAA_TEXTURES"	"battle_building"
"east_euro_windmill_piece01_destruct02"	"RigidModels\\Buildings\\AAA_TEXTURES"	"battle_building"
"Ep1_city_farm_corn"	"RigidModels/CampaignBuildings/Jamestown/Textures"	"campaign_building"
"Ep1_city_plantation_cotton"	"RigidModels/CampaignBuildings/Jamestown/Textures"	"campaign_building"
"Ep1_city_plantation_tobacco"	"RigidModels/CampaignBuildings/Jamestown/Textures"	"campaign_building"
"Ep1_port_fishery"	"RigidModels/CampaignBuildings/Jamestown/Textures"	"campaign_building"
"EU_building_placeholder"	"RigidModels/CampaignBuildings/Textures"	"campaign_building"
"EU_campaign_city_1slot_siege"	"RigidModels/CampaignBuildings/SiegeModels/Textures"	"campaign_template_extra"
"EU_City_1_slot"	"RigidModels/CampaignBuildings/Textures"	"campaign_template"
"EU_City_1_slot_fortifications_lvl0"	"RigidModels/CampaignBuildings/Textures"	"campaign_template"
"EU_City_1_slot_fortifications_lvl1"	"RigidModels/CampaignBuildings/Textures"	"campaign_template"
"EU_City_1_slot_fortifications_lvl2"	"RigidModels/CampaignBuildings/Textures"	"campaign_template"
"EU_City_1_slot_fortified"	"RigidModels/CampaignBuildings/Textures"	"campaign_template"
"EU_City_1_slot_fortified_minibuildings_wealth1"	"RigidModels/CampaignBuildings/Textures"	"campaign_template_extra"
"EU_City_1_slot_fortified_minibuildings_wealth2"	"RigidModels/CampaignBuildings/Textures"	"campaign_template_extra"
"EU_City_1_slot_fortified_minibuildings_wealth3"	"RigidModels/CampaignBuildings/Textures"	"campaign_template_extra"
"EU_City_1_slot_fortified_minibuildings_wealth4"	"RigidModels/CampaignBuildings/Textures"	"campaign_template_extra"
"EU_City_1_slot_fortified_minibuildings_wealth5"	"RigidModels/CampaignBuildings/Textures"	"campaign_template_extra"
"EU_City_1_slot_minibuildings_wealth1"	"RigidModels/CampaignBuildings/Textures"	"campaign_template_extra"
"EU_City_1_slot_minibuildings_wealth2"	"RigidModels/CampaignBuildings/Textures"	"campaign_template_extra"
"EU_City_1_slot_minibuildings_wealth3"	"RigidModels/CampaignBuildings/Textures"	"campaign_template_extra"
"EU_City_1_slot_minibuildings_wealth4"	"RigidModels/CampaignBuildings/Textures"	"campaign_template_extra"
"EU_City_1_slot_minibuildings_wealth5"	"RigidModels/CampaignBuildings/Textures"	"campaign_template_extra"
"EU_City_4_slot"	"RigidModels/CampaignBuildings/Textures"	"campaign_template"
"EU_City_4_slot_fortifications_lvl0"	"RigidModels/CampaignBuildings/Textures"	"campaign_template"
"EU_City_4_slot_fortifications_lvl1"	"RigidModels/CampaignBuildings/Textures"	"campaign_template"
"EU_City_4_slot_fortifications_lvl2"	"RigidModels/CampaignBuildings/Textures"	"campaign_template"
"EU_City_4_slot_fortified"	"RigidModels/CampaignBuildings/Textures"	"campaign_template"
"EU_City_4_slot_fortified_minibuildings_wealth1"	"RigidModels/CampaignBuildings/Textures"	"campaign_template_extra"
"EU_City_4_slot_fortified_minibuildings_wealth2"	"RigidModels/CampaignBuildings/Textures"	"campaign_template_extra"
"EU_City_4_slot_fortified_minibuildings_wealth3"	"RigidModels/CampaignBuildings/Textures"	"campaign_template_extra"
"EU_City_4_slot_fortified_minibuildings_wealth4"	"RigidModels/CampaignBuildings/Textures"	"campaign_template_extra"
"EU_City_4_slot_fortified_minibuildings_wealth5"	"RigidModels/CampaignBuildings/Textures"	"campaign_template_extra"
"EU_City_4_slot_minibuildings_wealth1"	"RigidModels/CampaignBuildings/Textures"	"campaign_template_extra"
"EU_City_4_slot_minibuildings_wealth2"	"RigidModels/CampaignBuildings/Textures"	"campaign_template_extra"
"EU_City_4_slot_minibuildings_wealth3"	"RigidModels/CampaignBuildings/Textures"	"campaign_template_extra"
"EU_City_4_slot_minibuildings_wealth4"	"RigidModels/CampaignBuildings/Textures"	"campaign_template_extra"
"EU_City_4_slot_minibuildings_wealth5"	"RigidModels/CampaignBuildings/Textures"	"campaign_template_extra"
"EU_City_5_slot"	"RigidModels/CampaignBuildings/Textures"	"campaign_template"
"EU_City_5_slot_fortifications_lvl0"	"RigidModels/CampaignBuildings/Textures"	"campaign_template_extra"
"EU_City_5_slot_fortifications_lvl1"	"RigidModels/CampaignBuildings/Textures"	"campaign_template_extra"
"EU_City_5_slot_fortifications_lvl2"	"RigidModels/CampaignBuildings/Textures"	"campaign_template_extra"
"EU_City_5_slot_fortified"	"RigidModels/CampaignBuildings/Textures"	"campaign_template"
"EU_City_5_slot_fortified_minibuildings_wealth1"	"RigidModels/CampaignBuildings/Textures"	"campaign_template_extra"
"EU_City_5_slot_fortified_minibuildings_wealth2"	"RigidModels/CampaignBuildings/Textures"	"campaign_template_extra"
"EU_City_5_slot_fortified_minibuildings_wealth3"	"RigidModels/CampaignBuildings/Textures"	"campaign_template_extra"
"EU_City_5_slot_fortified_minibuildings_wealth4"	"RigidModels/CampaignBuildings/Textures"	"campaign_template_extra"
"EU_City_5_slot_fortified_minibuildings_wealth5"	"RigidModels/CampaignBuildings/Textures"	"campaign_template_extra"
"EU_City_5_slot_minibuildings_wealth1"	"RigidModels/CampaignBuildings/Textures"	"campaign_template_extra"
"EU_City_5_slot_minibuildings_wealth2"	"RigidModels/CampaignBuildings/Textures"	"campaign_template_extra"
"EU_City_5_slot_minibuildings_wealth3"	"RigidModels/CampaignBuildings/Textures"	"campaign_template_extra"
"EU_City_5_slot_minibuildings_wealth4"	"RigidModels/CampaignBuildings/Textures"	"campaign_template_extra"
"EU_City_5_slot_minibuildings_wealth5"	"RigidModels/CampaignBuildings/Textures"	"campaign_template_extra"
"EU_city_artillery_lvl1"	"RigidModels/CampaignBuildings/Textures"	"campaign_building"
"EU_city_artillery_lvl2"	"RigidModels/CampaignBuildings/Textures"	"campaign_building"
"EU_city_artillery_lvl3"	"RigidModels/CampaignBuildings/Textures"	"campaign_building"
"EU_city_artillery_lvl4"	"RigidModels/CampaignBuildings/Textures"	"campaign_building"
"EU_city_artillery_lvl5"	"RigidModels/CampaignBuildings/Textures"	"campaign_building"
"EU_city_artillery_lvl6"	"RigidModels/CampaignBuildings/Textures"	"campaign_building"
"EU_city_culture_lvl1"	"RigidModels/CampaignBuildings/Textures"	"campaign_building"
"EU_city_culture_lvl2"	"RigidModels/CampaignBuildings/Textures"	"campaign_building"
"EU_city_culture_lvl3_observatory"	"RigidModels/CampaignBuildings/Textures"	"campaign_building"
"EU_city_culture_lvl3_operahouse"	"RigidModels/CampaignBuildings/Textures"	"campaign_building"
"EU_city_culture_lvl4_academy"	"RigidModels/CampaignBuildings/Textures"	"campaign_building"
"EU_city_culture_lvl4_museum"	"RigidModels/CampaignBuildings/Textures"	"campaign_building"
"EU_city_government_lvl1"	"RigidModels/CampaignBuildings/Textures"	"campaign_building"
"EU_city_government_lvl2"	"RigidModels/CampaignBuildings/Textures"	"campaign_building"
"EU_city_government_lvl3"	"RigidModels/CampaignBuildings/Textures"	"campaign_building"
"EU_city_government_lvl4"	"RigidModels/CampaignBuildings/Textures"	"campaign_building"
"EU_city_government_lvl5"	"RigidModels/CampaignBuildings/Textures"	"campaign_building"
"EU_city_government_lvl6"	"RigidModels/CampaignBuildings/Textures"	"campaign_building"
"EU_city_military_lvl1"	"RigidModels/CampaignBuildings/Textures"	"campaign_building"
"EU_city_military_lvl2"	"RigidModels/CampaignBuildings/Textures"	"campaign_building"
"EU_city_military_lvl3"	"RigidModels/CampaignBuildings/Textures"	"campaign_building"
"EU_city_military_lvl4"	"RigidModels/CampaignBuildings/Textures"	"campaign_building"
"EU_city_military_lvl5"	"RigidModels/CampaignBuildings/Textures"	"campaign_building"
"EU_city_naval_lvl1"	"RigidModels/CampaignBuildings/Textures"	"campaign_building"
"EU_city_naval_lvl2"	"RigidModels/CampaignBuildings/Textures"	"campaign_building"
"EU_city_naval_lvl3"	"RigidModels/CampaignBuildings/Textures"	"campaign_building"
"EU_Fort_lvl4"	"RigidModels/CampaignBuildings/Textures"	"campaign_fort"
"EU_Fort_lvl5"	"RigidModels/CampaignBuildings/Textures"	"campaign_fort"
"EU_port_fishing_lvl1"	"RigidModels/CampaignBuildings/Textures"	"campaign_building"
"EU_port_fishing_lvl2"	"RigidModels/CampaignBuildings/Textures"	"campaign_building"
"EU_port_fishing_lvl3"	"RigidModels/CampaignBuildings/Textures"	"campaign_building"
"EU_port_military_lvl1"	"RigidModels/CampaignBuildings/Textures"	"campaign_building"
"EU_port_military_lvl2"	"RigidModels/CampaignBuildings/Textures"	"campaign_building"
"EU_port_military_lvl3"	"RigidModels/CampaignBuildings/Textures"	"campaign_building"
"EU_port_military_lvl4_hospital"	"RigidModels/CampaignBuildings/Textures"	"campaign_building"
"EU_port_military_lvl4_steam"	"RigidModels/CampaignBuildings/Textures"	"campaign_building"
"EU_Port_slot"	"RigidModels/CampaignBuildings/Textures"	"campaign_template_extra"
"EU_Port_slot_minibuildings_wealth1"	"RigidModels/CampaignBuildings/Textures"	"campaign_template_extra"
"EU_Port_slot_minibuildings_wealth2"	"RigidModels/CampaignBuildings/Textures"	"campaign_template_extra"
"EU_Port_slot_minibuildings_wealth3"	"RigidModels/CampaignBuildings/Textures"	"campaign_template_extra"
"EU_Port_slot_minibuildings_wealth4"	"RigidModels/CampaignBuildings/Textures"	"campaign_template_extra"
"EU_Port_slot_minibuildings_wealth5"	"RigidModels/CampaignBuildings/Textures"	"campaign_template_extra"
"EU_port_trade_lvl1"	"RigidModels/CampaignBuildings/Textures"	"campaign_building"
"EU_port_trade_lvl2"	"RigidModels/CampaignBuildings/Textures"	"campaign_building"
"EU_port_trade_lvl3"	"RigidModels/CampaignBuildings/Textures"	"campaign_building"
"EU_port_trade_lvl4"	"RigidModels/CampaignBuildings/Textures"	"campaign_building"
"EU_Port_Village_slot"	"RigidModels/CampaignBuildings/Textures"	"campaign_template"
"EU_resource_farm_lvl5"	"RigidModels/CampaignBuildings/Textures"	"campaign_building"
"EU_resource_farm_lvl5_corn"	"RigidModels/CampaignBuildings/Textures"	"campaign_building"
"EU_resource_farm_lvl5_sheep"	"RigidModels/CampaignBuildings/Textures"	"campaign_building"
"EU_resource_farm_lvl5_wheat"	"RigidModels/CampaignBuildings/Textures"	"campaign_building"
"EU_resource_furtrader_lvl1"	"RigidModels/CampaignBuildings/Textures"	"campaign_building"
"EU_resource_furtrader_lvl2"	"RigidModels/CampaignBuildings/Textures"	"campaign_building"
"EU_resource_furtrader_lvl3"	"RigidModels/CampaignBuildings/Textures"	"campaign_building"
"EU_resource_plantation_coffee_lvl1"	"RigidModels/CampaignBuildings/Textures"	"campaign_building"
"EU_resource_plantation_coffee_lvl2"	"RigidModels/CampaignBuildings/Textures"	"campaign_building"
"EU_resource_plantation_coffee_lvl3"	"RigidModels/CampaignBuildings/Textures"	"campaign_building"
"EU_resource_plantation_cotton_lvl1"	"RigidModels/CampaignBuildings/Textures"	"campaign_building"
"EU_resource_plantation_cotton_lvl2"	"RigidModels/CampaignBuildings/Textures"	"campaign_building"
"EU_resource_plantation_cotton_lvl3"	"RigidModels/CampaignBuildings/Textures"	"campaign_building"
"EU_resource_plantation_spices_lvl1"	"RigidModels/CampaignBuildings/Textures"	"campaign_building"
"EU_resource_plantation_spices_lvl2"	"RigidModels/CampaignBuildings/Textures"	"campaign_building"
"EU_resource_plantation_spices_lvl3"	"RigidModels/CampaignBuildings/Textures"	"campaign_building"
"EU_resource_plantation_sugar_lvl1"	"RigidModels/CampaignBuildings/Textures"	"campaign_building"
"EU_resource_plantation_sugar_lvl2"	"RigidModels/CampaignBuildings/Textures"	"campaign_building"
"EU_resource_plantation_sugar_lvl3"	"RigidModels/CampaignBuildings/Textures"	"campaign_building"
"EU_resource_plantation_tea_lvl1"	"RigidModels/CampaignBuildings/Textures"	"campaign_building"
"EU_resource_plantation_tea_lvl2"	"RigidModels/CampaignBuildings/Textures"	"campaign_building"
"EU_resource_plantation_tea_lvl3"	"RigidModels/CampaignBuildings/Textures"	"campaign_building"
"EU_resource_plantation_tobacco_lvl1"	"RigidModels/CampaignBuildings/Textures"	"campaign_building"
"EU_resource_plantation_tobacco_lvl2"	"RigidModels/CampaignBuildings/Textures"	"campaign_building"
"EU_resource_plantation_tobacco_lvl3"	"RigidModels/CampaignBuildings/Textures"	"campaign_building"
"EU_resource_ricepaddy_lvl1"	"RigidModels/CampaignBuildings/Textures"	"campaign_building"
"EU_resource_ricepaddy_lvl2"	"RigidModels/CampaignBuildings/Textures"	"campaign_building"
"EU_resource_ricepaddy_lvl3"	"RigidModels/CampaignBuildings/Textures"	"campaign_building"
"EU_resource_timber_lvl1"	"RigidModels/CampaignBuildings/Textures"	"campaign_building"
"EU_resource_vineyards_lvl1"	"RigidModels/CampaignBuildings/Textures"	"campaign_building"
"EU_resource_vineyards_lvl2"	"RigidModels/CampaignBuildings/Textures"	"campaign_building"
"EU_resource_vineyards_lvl3"	"RigidModels/CampaignBuildings/Textures"	"campaign_building"
"EU_town_education_lvl1"	"RigidModels/CampaignBuildings/Textures"	"campaign_building"
"EU_town_education_lvl1_religious"	"RigidModels/CampaignBuildings/Textures"	"campaign_building"
"EU_town_education_lvl2_religious"	"RigidModels/CampaignBuildings/Textures"	"campaign_building"
"EU_town_education_lvl2_secular"	"RigidModels/CampaignBuildings/Textures"	"campaign_building"
"EU_town_education_lvl3_religious"	"RigidModels/CampaignBuildings/Textures"	"campaign_building"
"EU_town_education_lvl3_secular"	"RigidModels/CampaignBuildings/Textures"	"campaign_building"
"EU_town_education_lvl4_secular"	"RigidModels/CampaignBuildings/Textures"	"campaign_building"
"EU_town_happy_lvl1"	"RigidModels/CampaignBuildings/Textures"	"campaign_building"
"EU_town_happy_lvl2"	"RigidModels/CampaignBuildings/Textures"	"campaign_building"
"EU_town_happy_lvl3"	"RigidModels/CampaignBuildings/Textures"	"campaign_building"
"EU_town_happy_lvl4"	"RigidModels/CampaignBuildings/Textures"	"campaign_building"
"eu_town_ind_lvl1_metalworks"	"RigidModels/CampaignBuildings/Textures"	"campaign_building"
"eu_town_ind_lvl1_pottery"	"RigidModels/CampaignBuildings/Textures"	"campaign_building"
"eu_town_ind_lvl1_weavers"	"RigidModels/CampaignBuildings/Textures"	"campaign_building"
"EU_town_ind_lvl2_metalworks"	"RigidModels/CampaignBuildings/Textures"	"campaign_building"
"eu_town_ind_lvl2_mill"	"RigidModels/CampaignBuildings/Textures"	"campaign_building"
"EU_town_ind_lvl2_pottery"	"RigidModels/CampaignBuildings/Textures"	"campaign_building"
"EU_town_ind_lvl2_weavers"	"RigidModels/CampaignBuildings/Textures"	"campaign_building"
"EU_town_ind_lvl3_metalworks"	"RigidModels/CampaignBuildings/Textures"	"campaign_building"
"EU_town_ind_lvl3_pottery"	"RigidModels/CampaignBuildings/Textures"	"campaign_building"
"EU_town_ind_lvl4_pottery"	"RigidModels/CampaignBuildings/Textures"	"campaign_building"
"EU_town_military_lvl1"	"RigidModels/CampaignBuildings/Textures"	"campaign_building"
"EU_town_military_lvl2"	"RigidModels/CampaignBuildings/Textures"	"campaign_building"
"EU_town_military_lvl3"	"RigidModels/CampaignBuildings/Textures"	"campaign_building"
"EU_town_military_lvl4"	"RigidModels/CampaignBuildings/Textures"	"campaign_building"
"EU_town_military_lvl5_artillery"	"RigidModels/CampaignBuildings/Textures"	"campaign_building"
"EU_town_military_lvl5_barracks"	"RigidModels/CampaignBuildings/Textures"	"campaign_building"
"EU_town_military_lvl5_hospital"	"RigidModels/CampaignBuildings/Textures"	"campaign_building"
"EU_town_military_lvl5_stable"	"RigidModels/CampaignBuildings/Textures"	"campaign_building"
"EU_Town_slot"	"RigidModels/CampaignBuildings/Textures"	"campaign_template"
"EU_Town_slot_minibuildings_wealth1"	"RigidModels/CampaignBuildings/Textures"	"campaign_template_extra"
"EU_Town_slot_minibuildings_wealth2"	"RigidModels/CampaignBuildings/Textures"	"campaign_template_extra"
"EU_Town_slot_minibuildings_wealth3"	"RigidModels/CampaignBuildings/Textures"	"campaign_template_extra"
"EU_Town_slot_minibuildings_wealth4"	"RigidModels/CampaignBuildings/Textures"	"campaign_template_extra"
"EU_Town_slot_minibuildings_wealth5"	"RigidModels/CampaignBuildings/Textures"	"campaign_template_extra"
"EU_Town_Village_slot"	"RigidModels/CampaignBuildings/Textures"	"campaign_template"
"euro_stone_armoury01_piece01_destruct01"	"RigidModels\\Buildings\\AAA_TEXTURES"	"battle_building"
"euro_stone_armoury01_piece01_destruct02"	"RigidModels\\Buildings\\AAA_TEXTURES"	"battle_building"
"euro_stone_armoury01_piece01_destruct03"	"RigidModels\\Buildings\\AAA_TEXTURES"	"battle_building"
"euro_stone_armoury02_piece01_destruct01"	"RigidModels\\Buildings\\AAA_TEXTURES"	"battle_building"
"euro_stone_armoury02_piece01_destruct02"	"RigidModels\\Buildings\\AAA_TEXTURES"	"battle_building"
"euro_stone_armoury02_piece01_destruct03"	"RigidModels\\Buildings\\AAA_TEXTURES"	"battle_building"
"euro_stone_armoury02_piece02_destruct01"	"RigidModels\\Buildings\\AAA_TEXTURES"	"battle_building"
"euro_stone_armoury02_piece02_destruct02"	"RigidModels\\Buildings\\AAA_TEXTURES"	"battle_building"
"euro_stone_armoury02_piece02_destruct03"	"RigidModels\\Buildings\\AAA_TEXTURES"	"battle_building"
"euro_stone_barracks_piece01_destruct01"	"RigidModels\\Buildings\\AAA_TEXTURES"	"battle_building"
"euro_stone_barracks_piece01_destruct02"	"RigidModels\\Buildings\\AAA_TEXTURES"	"battle_building"
"euro_stone_barracks_piece01_destruct03"	"RigidModels\\Buildings\\AAA_TEXTURES"	"battle_building"
"euro_stone_barracks_piece02_destruct01"	"RigidModels\\Buildings\\AAA_TEXTURES"	"battle_building"
"euro_stone_barracks_piece02_destruct02"	"RigidModels\\Buildings\\AAA_TEXTURES"	"battle_building"
"euro_stone_barracks_piece02_destruct03"	"RigidModels\\Buildings\\AAA_TEXTURES"	"battle_building"
"euro_stone_command_hq_piece01_destruct01"	"RigidModels\\Buildings\\AAA_TEXTURES"	"battle_building"
"euro_stone_command_hq_piece01_destruct02"	"RigidModels\\Buildings\\AAA_TEXTURES"	"battle_building"
"euro_stone_command_hq_piece01_destruct03"	"RigidModels\\Buildings\\AAA_TEXTURES"	"battle_building"
"euro_stone_command_hq_piece02_destruct01"	"RigidModels\\Buildings\\AAA_TEXTURES"	"battle_building"
"euro_stone_command_hq_piece02_destruct02"	"RigidModels\\Buildings\\AAA_TEXTURES"	"battle_building"
"euro_stone_command_hq_piece02_destruct03"	"RigidModels\\Buildings\\AAA_TEXTURES"	"battle_building"
"european_warehouse01_piece01_destruct01"	"RigidModels\\Buildings\\AAA_TEXTURES"	"battle_building"
"european_warehouse01_piece01_destruct02"	"RigidModels\\Buildings\\AAA_TEXTURES"	"battle_building"
"european_warehouse01_piece01_destruct03"	"RigidModels\\Buildings\\AAA_TEXTURES"	"battle_building"
"european_warehouse01_piece02_destruct01"	"RigidModels\\Buildings\\AAA_TEXTURES"	"battle_building"
"european_warehouse01_piece02_destruct02"	"RigidModels\\Buildings\\AAA_TEXTURES"	"battle_building"
"european_warehouse01_piece02_destruct03"	"RigidModels\\Buildings\\AAA_TEXTURES"	"battle_building"
"european_warehouse02_piece01_destruct01"	"RigidModels\\Buildings\\AAA_TEXTURES"	"battle_building"
"european_warehouse02_piece01_destruct02"	"RigidModels\\Buildings\\AAA_TEXTURES"	"battle_building"
"european_warehouse02_piece01_destruct03"	"RigidModels\\Buildings\\AAA_TEXTURES"	"battle_building"
"european_warehouse02_piece02_destruct01"	"RigidModels\\Buildings\\AAA_TEXTURES"	"battle_building"
"european_warehouse02_piece02_destruct02"	"RigidModels\\Buildings\\AAA_TEXTURES"	"battle_building"
"european_warehouse02_piece02_destruct03"	"RigidModels\\Buildings\\AAA_TEXTURES"	"battle_building"
"european_warehouse03_piece01_destruct01"	"RigidModels\\Buildings\\AAA_TEXTURES"	"battle_building"
"european_warehouse03_piece01_destruct02"	"RigidModels\\Buildings\\AAA_TEXTURES"	"battle_building"
"european_warehouse03_piece01_destruct03"	"RigidModels\\Buildings\\AAA_TEXTURES"	"battle_building"
"european_warehouse03_piece02_destruct01"	"RigidModels\\Buildings\\AAA_TEXTURES"	"battle_building"
"european_warehouse03_piece02_destruct02"	"RigidModels\\Buildings\\AAA_TEXTURES"	"battle_building"
"european_warehouse03_piece02_destruct03"	"RigidModels\\Buildings\\AAA_TEXTURES"	"battle_building"
"european_warehouse04_piece01_destruct01"	"RigidModels\\Buildings\\AAA_TEXTURES"	"battle_building"
"european_warehouse04_piece01_destruct02"	"RigidModels\\Buildings\\AAA_TEXTURES"	"battle_building"
"european_warehouse04_piece01_destruct03"	"RigidModels\\Buildings\\AAA_TEXTURES"	"battle_building"
"european_warehouse04_piece02_destruct01"	"RigidModels\\Buildings\\AAA_TEXTURES"	"battle_building"
"european_warehouse04_piece02_destruct02"	"RigidModels\\Buildings\\AAA_TEXTURES"	"battle_building"
"european_warehouse04_piece02_destruct03"	"RigidModels\\Buildings\\AAA_TEXTURES"	"battle_building"
"facing_arrow_proxy"	"RigidModels\\3DIndicators\\Textures"	"3Dindicators"
"famous_battle_event_marker_default"	"RigidModels/EventMarkers/Textures"	"campaign_event_markers"
"field_cannon_destroyed_model_18lb"	"EngineModels/Textures"	"battle_misc"
"field_cannon_destroyed_model_32lb"	"EngineModels/Textures"	"battle_misc"
"field_cannon_destroyed_model_9lb"	"EngineModels/Textures"	"battle_misc"
"Field_Cannon_Model_24lb_destructed"	"EngineModels/Textures"	"battle_misc"
"Field_Cannon_Model_destroyed_barrels_12lb"	"EngineModels/Textures"	"battle_misc"
"Field_Cannon_Model_destroyed_barrels_18lb"	"EngineModels/Textures"	"battle_misc"
"Field_Cannon_Model_destroyed_barrels_24lb"	"EngineModels/Textures"	"battle_misc"
"Field_Cannon_Model_destroyed_barrels_32lb"	"EngineModels/Textures"	"battle_misc"
"Field_Cannon_Model_destroyed_barrels_3lb"	"EngineModels/Textures"	"battle_misc"
"Field_Cannon_Model_destroyed_barrels_9lb"	"EngineModels/Textures"	"battle_misc"
"fmv_cross1_piece01_destruct01"	"RigidModels\\Buildings\\AAA_TEXTURES"	"battle_building"
"fmv_cross2_piece01_destruct01"	"RigidModels\\Buildings\\AAA_TEXTURES"	"battle_building"
"fmv_cross3_piece01_destruct01"	"RigidModels\\Buildings\\AAA_TEXTURES"	"battle_building"
"fmv_cross4_piece01_destruct01"	"RigidModels\\Buildings\\AAA_TEXTURES"	"battle_building"
"fmv_mayflower_piece01_destruct01"	"RigidModels\\naval\\textures"	"battle_building"
"fmv_rowboat_piece01_destruct01"	"RigidModels\\naval\\textures"	"battle_building"
"fmv_thirdrate_piece01_destruct01"	"RigidModels\\naval\\textures"	"battle_building"
"fort_euro_wooden_piece01_destruct01"	"RigidModels\\Buildings\\fort_euro_wooden"	"battle_building"
"fort_euro_wooden_piece02_destruct01"	"RigidModels\\Buildings\\fort_euro_wooden"	"battle_building"
"fort_euro_wooden_piece02_destruct02"	"RigidModels\\Buildings\\fort_euro_wooden"	"battle_building"
"fort_euro_wooden_piece02_destruct03"	"RigidModels\\Buildings\\fort_euro_wooden"	"battle_building"
"fort_euro_wooden_piece03_destruct01"	"RigidModels\\Buildings\\fort_euro_wooden"	"battle_building"
"fort_euro_wooden_piece03_destruct02"	"RigidModels\\Buildings\\fort_euro_wooden"	"battle_building"
"fort_euro_wooden_piece03_destruct03"	"RigidModels\\Buildings\\fort_euro_wooden"	"battle_building"
"fort_euro_wooden_piece05_destruct01"	"RigidModels\\Buildings\\fort_euro_wooden"	"battle_building"
"fort_euro_wooden_piece05_destruct02"	"RigidModels\\Buildings\\fort_euro_wooden"	"battle_building"
"fort_euro_wooden_piece05_destruct03"	"RigidModels\\Buildings\\fort_euro_wooden"	"battle_building"
"fort_euro_wooden_piece06_destruct01_gate_closed"	"RigidModels\\Buildings\\fort_euro_wooden"	"battle_building"
"fort_euro_wooden_piece06_destruct01_gate_open"	"RigidModels\\Buildings\\fort_euro_wooden"	"battle_building"
"fort_euro_wooden_piece06_destruct02_gate_closed"	"RigidModels\\Buildings\\fort_euro_wooden"	"battle_building"
"fort_euro_wooden_piece06_destruct02_gate_open"	"RigidModels\\Buildings\\fort_euro_wooden"	"battle_building"
"fort_indian_piece01_destruct01_gate_closed"	"RigidModels\\Buildings\\fort_indian"	"battle_building"
"fort_indian_piece01_destruct01_gate_open"	"RigidModels\\Buildings\\fort_indian"	"battle_building"
"fort_indian_piece01_destruct02_gate_closed"	"RigidModels\\Buildings\\fort_indian"	"battle_building"
"fort_indian_piece01_destruct02_gate_open"	"RigidModels\\Buildings\\fort_indian"	"battle_building"
"fort_indian_piece02_destruct01"	"RigidModels\\Buildings\\fort_indian"	"battle_building"
"fort_indian_piece02_destruct02"	"RigidModels\\Buildings\\fort_indian"	"battle_building"
"fort_indian_piece02_destruct03"	"RigidModels\\Buildings\\fort_indian"	"battle_building"
"fort_indian_piece03_destruct01"	"RigidModels\\Buildings\\fort_indian"	"battle_building"
"fort_indian_piece03_destruct02"	"RigidModels\\Buildings\\fort_indian"	"battle_building"
"fort_indian_piece03_destruct03"	"RigidModels\\Buildings\\fort_indian"	"battle_building"
"fort_indian_piece04_destruct01"	"RigidModels\\Buildings\\fort_indian"	"battle_building"
"fort_indian_piece04_destruct02"	"RigidModels\\Buildings\\fort_indian"	"battle_building"
"fort_indian_piece04_destruct03"	"RigidModels\\Buildings\\fort_indian"	"battle_building"
"fort_indian_piece05_destruct01"	"RigidModels\\Buildings\\fort_indian"	"battle_building"
"fort_indian_piece05_destruct02"	"RigidModels\\Buildings\\fort_indian"	"battle_building"
"fort_indian_piece05_destruct03"	"RigidModels\\Buildings\\fort_indian"	"battle_building"
"fort_indian_piece06_destruct01"	"RigidModels\\Buildings\\fort_indian"	"battle_building"
"fort_indian_piece06_destruct02"	"RigidModels\\Buildings\\fort_indian"	"battle_building"
"fort_indian_piece06_destruct03"	"RigidModels\\Buildings\\fort_indian"	"battle_building"
"fort_indian_piece07_destruct01"	"RigidModels\\Buildings\\fort_indian"	"battle_building"
"fort_indian_piece07_destruct02"	"RigidModels\\Buildings\\fort_indian"	"battle_building"
"fort_indian_piece07_destruct03"	"RigidModels\\Buildings\\fort_indian"	"battle_building"
"fort_indian_piece08_destruct01"	"RigidModels\\Buildings\\fort_indian"	"battle_building"
"fort_indian_piece08_destruct02"	"RigidModels\\Buildings\\fort_indian"	"battle_building"
"fort_indian_piece08_destruct03"	"RigidModels\\Buildings\\fort_indian"	"battle_building"
"fort_indian_piece09_destruct01"	"RigidModels\\Buildings\\fort_indian"	"battle_building"
"fort_indian_piece10_destruct01"	"RigidModels\\Buildings\\fort_indian"	"battle_building"
"fort_indian_piece10_destruct02"	"RigidModels\\Buildings\\fort_indian"	"battle_building"
"fort_indian_piece10_destruct03"	"RigidModels\\Buildings\\fort_indian"	"battle_building"
"fort_indian_piece11_destruct01"	"RigidModels\\Buildings\\fort_indian"	"battle_building"
"fort_indian_piece11_destruct02"	"RigidModels\\Buildings\\fort_indian"	"battle_building"
"fort_indian_piece11_destruct03"	"RigidModels\\Buildings\\fort_indian"	"battle_building"
"fort_indian_small_piece01_destruct01_gate_closed"	"RigidModels\\Buildings\\fort_indian_small"	"battle_building"
"fort_indian_small_piece01_destruct01_gate_open"	"RigidModels\\Buildings\\fort_indian_small"	"battle_building"
"fort_indian_small_piece01_destruct02_gate_closed"	"RigidModels\\Buildings\\fort_indian_small"	"battle_building"
"fort_indian_small_piece01_destruct02_gate_open"	"RigidModels\\Buildings\\fort_indian_small"	"battle_building"
"fort_indian_small_piece03_destruct01"	"RigidModels\\Buildings\\fort_indian_small"	"battle_building"
"fort_indian_small_piece03_destruct02"	"RigidModels\\Buildings\\fort_indian_small"	"battle_building"
"fort_indian_small_piece03_destruct03"	"RigidModels\\Buildings\\fort_indian_small"	"battle_building"
"fort_indian_small_piece04_destruct01"	"RigidModels\\Buildings\\fort_indian_small"	"battle_building"
"fort_indian_small_piece04_destruct02"	"RigidModels\\Buildings\\fort_indian_small"	"battle_building"
"fort_indian_small_piece04_destruct03"	"RigidModels\\Buildings\\fort_indian_small"	"battle_building"
"fort_indian_small_piece05_destruct01"	"RigidModels\\Buildings\\fort_indian_small"	"battle_building"
"fort_indian_small_piece05_destruct02"	"RigidModels\\Buildings\\fort_indian_small"	"battle_building"
"fort_indian_small_piece05_destruct03"	"RigidModels\\Buildings\\fort_indian_small"	"battle_building"
"fort_indian_small_piece07_destruct01"	"RigidModels\\Buildings\\fort_indian_small"	"battle_building"
"fort_indian_small_piece07_destruct02"	"RigidModels\\Buildings\\fort_indian_small"	"battle_building"
"fort_indian_small_piece07_destruct03"	"RigidModels\\Buildings\\fort_indian_small"	"battle_building"
"fort_indian_small_piece08_destruct01"	"RigidModels\\Buildings\\fort_indian_small"	"battle_building"
"fort_indian_small_piece08_destruct02"	"RigidModels\\Buildings\\fort_indian_small"	"battle_building"
"fort_indian_small_piece08_destruct03"	"RigidModels\\Buildings\\fort_indian_small"	"battle_building"
"fort_indian_small_piece09_destruct01"	"RigidModels\\Buildings\\fort_indian_small"	"battle_building"
"fort_indian_small_piece10_destruct01"	"RigidModels\\Buildings\\fort_indian_small"	"battle_building"
"fort_indian_small_piece10_destruct02"	"RigidModels\\Buildings\\fort_indian_small"	"battle_building"
"fort_indian_small_piece10_destruct03"	"RigidModels\\Buildings\\fort_indian_small"	"battle_building"
"fort_indian_small_piece11_destruct01"	"RigidModels\\Buildings\\fort_indian_small"	"battle_building"
"fort_indian_small_piece11_destruct02"	"RigidModels\\Buildings\\fort_indian_small"	"battle_building"
"fort_indian_small_piece11_destruct03"	"RigidModels\\Buildings\\fort_indian_small"	"battle_building"
"fort_jamestown_piece01_destruct01"	"RigidModels\\Buildings\\fort_jamestown"	"battle_building"
"fort_jamestown_piece01_destruct02"	"RigidModels\\Buildings\\fort_jamestown"	"battle_building"
"fort_jamestown_piece01_destruct03"	"RigidModels\\Buildings\\fort_jamestown"	"battle_building"
"fort_jamestown_piece02_destruct01"	"RigidModels\\Buildings\\fort_jamestown"	"battle_building"
"fort_jamestown_piece02_destruct02"	"RigidModels\\Buildings\\fort_jamestown"	"battle_building"
"fort_jamestown_piece02_destruct03"	"RigidModels\\Buildings\\fort_jamestown"	"battle_building"
"fort_jamestown_piece03_destruct01"	"RigidModels\\Buildings\\fort_jamestown"	"battle_building"
"fort_jamestown_piece03_destruct02"	"RigidModels\\Buildings\\fort_jamestown"	"battle_building"
"fort_jamestown_piece03_destruct03"	"RigidModels\\Buildings\\fort_jamestown"	"battle_building"
"fort_jamestown_piece04_destruct01"	"RigidModels\\Buildings\\fort_jamestown"	"battle_building"
"fort_jamestown_piece04_destruct02"	"RigidModels\\Buildings\\fort_jamestown"	"battle_building"
"fort_jamestown_piece04_destruct03"	"RigidModels\\Buildings\\fort_jamestown"	"battle_building"
"fort_jamestown_piece05_destruct01"	"RigidModels\\Buildings\\fort_jamestown"	"battle_building"
"fort_jamestown_piece05_destruct02"	"RigidModels\\Buildings\\fort_jamestown"	"battle_building"
"fort_jamestown_piece05_destruct03"	"RigidModels\\Buildings\\fort_jamestown"	"battle_building"
"fort_jamestown_piece06_destruct01"	"RigidModels\\Buildings\\fort_jamestown"	"battle_building"
"fort_jamestown_piece06_destruct02"	"RigidModels\\Buildings\\fort_jamestown"	"battle_building"
"fort_jamestown_piece06_destruct03"	"RigidModels\\Buildings\\fort_jamestown"	"battle_building"
"fort_jamestown_piece07_destruct01_gate_closed"	"RigidModels\\Buildings\\fort_jamestown"	"battle_building"
"fort_jamestown_piece07_destruct01_gate_open"	"RigidModels\\Buildings\\fort_jamestown"	"battle_building"
"fort_jamestown_piece07_destruct02_gate_closed"	"RigidModels\\Buildings\\fort_jamestown"	"battle_building"
"fort_jamestown_piece07_destruct02_gate_open"	"RigidModels\\Buildings\\fort_jamestown"	"battle_building"
"Fort_lvl1"	"RigidModels/CampaignBuildings/Textures"	"campaign_fort"
"Fort_lvl2"	"RigidModels/CampaignBuildings/Textures"	"campaign_fort"
"Fort_lvl3"	"RigidModels/CampaignBuildings/Textures"	"campaign_fort"
"fort_ottoman_piece01_destruct01"	"RigidModels\\Buildings\\fort_ottoman"	"battle_building"
"fort_ottoman_piece02_destruct01"	"RigidModels\\Buildings\\fort_ottoman"	"battle_building"
"fort_ottoman_piece02_destruct02"	"RigidModels\\Buildings\\fort_ottoman"	"battle_building"
"fort_ottoman_piece02_destruct03"	"RigidModels\\Buildings\\fort_ottoman"	"battle_building"
"fort_ottoman_piece04_destruct01"	"RigidModels\\Buildings\\fort_ottoman"	"battle_building"
"fort_ottoman_piece04_destruct02"	"RigidModels\\Buildings\\fort_ottoman"	"battle_building"
"fort_ottoman_piece04_destruct03"	"RigidModels\\Buildings\\fort_ottoman"	"battle_building"
"fort_ottoman_piece06_destruct01_gate_closed"	"RigidModels\\Buildings\\fort_ottoman"	"battle_building"
"fort_ottoman_piece06_destruct01_gate_open"	"RigidModels\\Buildings\\fort_ottoman"	"battle_building"
"fort_ottoman_piece06_destruct02_gate_closed"	"RigidModels\\Buildings\\fort_ottoman"	"battle_building"
"fort_ottoman_piece06_destruct02_gate_open"	"RigidModels\\Buildings\\fort_ottoman"	"battle_building"
"fort_ottoman_small_piece01_destruct01"	"RigidModels\\Buildings\\fort_ottoman_small"	"battle_building"
"fort_ottoman_small_piece04_destruct01"	"RigidModels\\Buildings\\fort_ottoman_small"	"battle_building"
"fort_ottoman_small_piece04_destruct02"	"RigidModels\\Buildings\\fort_ottoman_small"	"battle_building"
"fort_ottoman_small_piece04_destruct03"	"RigidModels\\Buildings\\fort_ottoman_small"	"battle_building"
"fort_ottoman_small_piece06_destruct01_gate_closed"	"RigidModels\\Buildings\\fort_ottoman_small"	"battle_building"
"fort_ottoman_small_piece06_destruct01_gate_open"	"RigidModels\\Buildings\\fort_ottoman_small"	"battle_building"
"fort_ottoman_small_piece06_destruct02_gate_closed"	"RigidModels\\Buildings\\fort_ottoman_small"	"battle_building"
"fort_ottoman_small_piece06_destruct02_gate_open"	"RigidModels\\Buildings\\fort_ottoman_small"	"battle_building"
"fort_star_piece01_destruct01"	"RigidModels\\Buildings\\fort_star"	"battle_building"
"fort_star_piece01_destruct02"	"RigidModels\\Buildings\\fort_star"	"battle_building"
"fort_star_piece01_destruct03"	"RigidModels\\Buildings\\fort_star"	"battle_building"
"fort_star_piece02_destruct01"	"RigidModels\\Buildings\\fort_star"	"battle_building"
"fort_star_piece03_destruct01"	"RigidModels\\Buildings\\fort_star"	"battle_building"
"fort_star_piece03_destruct02"	"RigidModels\\Buildings\\fort_star"	"battle_building"
"fort_star_piece03_destruct03"	"RigidModels\\Buildings\\fort_star"	"battle_building"
"fort_star_piece04_destruct01"	"RigidModels\\Buildings\\fort_star"	"battle_building"
"fort_star_piece04_destruct02"	"RigidModels\\Buildings\\fort_star"	"battle_building"
"fort_star_piece04_destruct03"	"RigidModels\\Buildings\\fort_star"	"battle_building"
"fort_star_piece05_destruct01"	"RigidModels\\Buildings\\fort_star"	"battle_building"
"fort_star_piece05_destruct02"	"RigidModels\\Buildings\\fort_star"	"battle_building"
"fort_star_piece05_destruct03"	"RigidModels\\Buildings\\fort_star"	"battle_building"
"fort_star_piece06_destruct01"	"RigidModels\\Buildings\\fort_star"	"battle_building"
"fort_star_piece06_destruct02"	"RigidModels\\Buildings\\fort_star"	"battle_building"
"fort_star_piece07_destruct01"	"RigidModels\\Buildings\\fort_star"	"battle_building"
"fort_star_piece07_destruct02"	"RigidModels\\Buildings\\fort_star"	"battle_building"
"fort_star_piece07_destruct03"	"RigidModels\\Buildings\\fort_star"	"battle_building"
"fort_star_piece08_destruct01"	"RigidModels\\Buildings\\fort_star"	"battle_building"
"fort_star_piece08_destruct02"	"RigidModels\\Buildings\\fort_star"	"battle_building"
"fort_star_piece08_destruct03"	"RigidModels\\Buildings\\fort_star"	"battle_building"
"fort_star_piece09_destruct01_gate_closed"	"RigidModels\\Buildings\\fort_star"	"battle_building"
"fort_star_piece09_destruct01_gate_open"	"RigidModels\\Buildings\\fort_star"	"battle_building"
"fort_star_piece09_destruct02_gate_closed"	"RigidModels\\Buildings\\fort_star"	"battle_building"
"fort_star_piece09_destruct02_gate_open"	"RigidModels\\Buildings\\fort_star"	"battle_building"
"fort_stockade_piece01_destruct01"	"RigidModels\\Buildings\\fort_stockade"	"battle_building"
"fort_stockade_piece02_destruct01"	"RigidModels\\Buildings\\fort_stockade"	"battle_building"
"fort_stockade_piece02_destruct02"	"RigidModels\\Buildings\\fort_stockade"	"battle_building"
"fort_stockade_piece02_destruct03"	"RigidModels\\Buildings\\fort_stockade"	"battle_building"
"fort_stockade_piece03_destruct01"	"RigidModels\\Buildings\\fort_stockade"	"battle_building"
"fort_stockade_piece03_destruct02"	"RigidModels\\Buildings\\fort_stockade"	"battle_building"
"fort_stockade_piece03_destruct03"	"RigidModels\\Buildings\\fort_stockade"	"battle_building"
"fort_stockade_piece04_destruct01_gate_closed"	"RigidModels\\Buildings\\fort_stockade"	"battle_building"
"fort_stockade_piece04_destruct01_gate_open"	"RigidModels\\Buildings\\fort_stockade"	"battle_building"
"fort_stockade_piece04_destruct02_gate_closed"	"RigidModels\\Buildings\\fort_stockade"	"battle_building"
"fort_stockade_piece04_destruct02_gate_open"	"RigidModels\\Buildings\\fort_stockade"	"battle_building"
"fort_town_piece01_destruct01"	"RigidModels\\Buildings\\fort_town"	"battle_building"
"fort_town_piece01_destruct02"	"RigidModels\\Buildings\\fort_town"	"battle_building"
"fort_town_piece01_destruct03"	"RigidModels\\Buildings\\fort_town"	"battle_building"
"fort_town_piece02_destruct01"	"RigidModels\\Buildings\\fort_town"	"battle_building"
"fort_town_piece02_destruct02"	"RigidModels\\Buildings\\fort_town"	"battle_building"
"fort_town_piece02_destruct03"	"RigidModels\\Buildings\\fort_town"	"battle_building"
"fort_town_piece03_destruct01"	"RigidModels\\Buildings\\fort_town"	"battle_building"
"fort_town_piece07_destruct01_gate_closed"	"RigidModels\\Buildings\\fort_town"	"battle_building"
"fort_town_piece07_destruct01_gate_open"	"RigidModels\\Buildings\\fort_town"	"battle_building"
"fort_town_piece07_destruct02_gate_closed"	"RigidModels\\Buildings\\fort_town"	"battle_building"
"fort_town_piece07_destruct02_gate_open"	"RigidModels\\Buildings\\fort_town"	"battle_building"
"good_cavalry_ground_marker"	"RigidModels\\WarscapeFrame\\ai_hints\\Textures"	"3Dindicators"
"grapple"	"UnitModels/Textures"	"projectiles"
"hedge_small_1_piece01_destruct01"	"RigidModels\\BattleFieldProps\\Textures"	"battle_misc"
"hedge_small_2_piece01_destruct01"	"RigidModels\\BattleFieldProps\\Textures"	"battle_misc"
"hedge_small_4_piece01_destruct01"	"RigidModels\\BattleFieldProps\\Textures"	"battle_misc"
"hedge_small_8_piece01_destruct01"	"RigidModels\\BattleFieldProps\\Textures"	"battle_misc"
"hedge_small_end_piece01_destruct01"	"RigidModels\\BattleFieldProps\\Textures"	"battle_misc"
"hedge_small_piece01_destruct01"	"RigidModels\\BattleFieldProps\\Textures"	"battle_misc"
"howitzer_destroyed_model_12lb"	"EngineModels/Textures"	"battle_misc"
"howitzer_destroyed_model_24lb"	"EngineModels/Textures"	"battle_misc"
"impassible_marker"	"RigidModels\\WarscapeFrame\\ai_hints\\Textures"	"3Dindicators"
"IND_City_1_slot"	"RigidModels/CampaignBuildings/Textures"	"campaign_template"
"IND_City_1_slot_fortifications"	"RigidModels/CampaignBuildings/Textures"	"campaign_template_extra"
"IND_City_1_slot_fortifications_lvl0"	"RigidModels/CampaignBuildings/Textures"	"campaign_template"
"IND_City_1_slot_fortifications_lvl1"	"RigidModels/CampaignBuildings/Textures"	"campaign_template"
"IND_City_1_slot_fortifications_lvl2"	"RigidModels/CampaignBuildings/Textures"	"campaign_template"
"IND_City_1_slot_fortified"	"RigidModels/CampaignBuildings/Textures"	"campaign_template"
"IND_City_1_slot_fortified_minibuildings_wealth1"	"RigidModels/CampaignBuildings/Textures"	"campaign_template_extra"
"IND_City_1_slot_fortified_minibuildings_wealth2"	"RigidModels/CampaignBuildings/Textures"	"campaign_template_extra"
"IND_City_1_slot_fortified_minibuildings_wealth3"	"RigidModels/CampaignBuildings/Textures"	"campaign_template_extra"
"IND_City_1_slot_fortified_minibuildings_wealth4"	"RigidModels/CampaignBuildings/Textures"	"campaign_template_extra"
"IND_City_1_slot_fortified_minibuildings_wealth5"	"RigidModels/CampaignBuildings/Textures"	"campaign_template_extra"
"IND_City_1_slot_minibuildings_wealth1"	"RigidModels/CampaignBuildings/Textures"	"campaign_template_extra"
"IND_City_1_slot_minibuildings_wealth2"	"RigidModels/CampaignBuildings/Textures"	"campaign_template_extra"
"IND_City_1_slot_minibuildings_wealth3"	"RigidModels/CampaignBuildings/Textures"	"campaign_template_extra"
"IND_City_1_slot_minibuildings_wealth4"	"RigidModels/CampaignBuildings/Textures"	"campaign_template_extra"
"IND_City_1_slot_minibuildings_wealth5"	"RigidModels/CampaignBuildings/Textures"	"campaign_template_extra"
"IND_City_4_slot"	"RigidModels/CampaignBuildings/Textures"	"campaign_template"
"IND_City_4_slot_fortifications"	"RigidModels/CampaignBuildings/Textures"	"campaign_template_extra"
"IND_City_4_slot_fortifications_lvl0"	"RigidModels/CampaignBuildings/Textures"	"campaign_template"
"IND_City_4_slot_fortifications_lvl1"	"RigidModels/CampaignBuildings/Textures"	"campaign_template"
"IND_City_4_slot_fortifications_lvl2"	"RigidModels/CampaignBuildings/Textures"	"campaign_template"
"IND_City_4_slot_fortified"	"RigidModels/CampaignBuildings/Textures"	"campaign_template_extra"
"IND_City_4_slot_fortified_minibuildings_wealth1"	"RigidModels/CampaignBuildings/Textures"	"campaign_template_extra"
"IND_City_4_slot_fortified_minibuildings_wealth2"	"RigidModels/CampaignBuildings/Textures"	"campaign_template_extra"
"IND_City_4_slot_fortified_minibuildings_wealth3"	"RigidModels/CampaignBuildings/Textures"	"campaign_template_extra"
"IND_City_4_slot_fortified_minibuildings_wealth4"	"RigidModels/CampaignBuildings/Textures"	"campaign_template_extra"
"IND_City_4_slot_fortified_minibuildings_wealth5"	"RigidModels/CampaignBuildings/Textures"	"campaign_template_extra"
"IND_City_4_slot_minibuildings_wealth1"	"RigidModels/CampaignBuildings/Textures"	"campaign_template_extra"
"IND_City_4_slot_minibuildings_wealth2"	"RigidModels/CampaignBuildings/Textures"	"campaign_template_extra"
"IND_City_4_slot_minibuildings_wealth3"	"RigidModels/CampaignBuildings/Textures"	"campaign_template_extra"
"IND_City_4_slot_minibuildings_wealth4"	"RigidModels/CampaignBuildings/Textures"	"campaign_template_extra"
"IND_City_4_slot_minibuildings_wealth5"	"RigidModels/CampaignBuildings/Textures"	"campaign_template_extra"
"IND_City_5_slot"	"RigidModels/CampaignBuildings/Textures"	"campaign_template"
"IND_City_5_slot_fortifications"	"RigidModels/CampaignBuildings/Textures"	"campaign_template_extra"
"IND_City_5_slot_fortifications_lvl0"	"RigidModels/CampaignBuildings/Textures"	"campaign_template"
"IND_City_5_slot_fortifications_lvl1"	"RigidModels/CampaignBuildings/Textures"	"campaign_template"
"IND_City_5_slot_fortifications_lvl2"	"RigidModels/CampaignBuildings/Textures"	"campaign_template"
"IND_City_5_slot_fortified"	"RigidModels/CampaignBuildings/Textures"	"campaign_template"
"IND_City_5_slot_fortified_minibuildings_wealth1"	"RigidModels/CampaignBuildings/Textures"	"campaign_template_extra"
"IND_City_5_slot_fortified_minibuildings_wealth2"	"RigidModels/CampaignBuildings/Textures"	"campaign_template_extra"
"IND_City_5_slot_fortified_minibuildings_wealth3"	"RigidModels/CampaignBuildings/Textures"	"campaign_template_extra"
"IND_City_5_slot_fortified_minibuildings_wealth4"	"RigidModels/CampaignBuildings/Textures"	"campaign_template_extra"
"IND_City_5_slot_fortified_minibuildings_wealth5"	"RigidModels/CampaignBuildings/Textures"	"campaign_template_extra"
"IND_City_5_slot_minibuildings_wealth1"	"RigidModels/CampaignBuildings/Textures"	"campaign_template_extra"
"IND_City_5_slot_minibuildings_wealth2"	"RigidModels/CampaignBuildings/Textures"	"campaign_template_extra"
"IND_City_5_slot_minibuildings_wealth3"	"RigidModels/CampaignBuildings/Textures"	"campaign_template_extra"
"IND_City_5_slot_minibuildings_wealth4"	"RigidModels/CampaignBuildings/Textures"	"campaign_template_extra"
"IND_City_5_slot_minibuildings_wealth5"	"RigidModels/CampaignBuildings/Textures"	"campaign_template_extra"
"IND_city_artillery_lvl1"	"RigidModels/CampaignBuildings/Textures"	"campaign_building"
"IND_city_artillery_lvl2"	"RigidModels/CampaignBuildings/Textures"	"campaign_building"
"IND_city_artillery_lvl3"	"RigidModels/CampaignBuildings/Textures"	"campaign_building"
"IND_city_artillery_lvl4"	"RigidModels/CampaignBuildings/Textures"	"campaign_building"
"IND_city_artillery_lvl5"	"RigidModels/CampaignBuildings/Textures"	"campaign_building"
"IND_city_artillery_lvl6"	"RigidModels/CampaignBuildings/Textures"	"campaign_building"
"IND_city_culture_lvl1"	"RigidModels/CampaignBuildings/Textures"	"campaign_building"
"IND_city_culture_lvl2"	"RigidModels/CampaignBuildings/Textures"	"campaign_building"
"IND_city_culture_lvl3_garden"	"RigidModels/CampaignBuildings/Textures"	"campaign_building"
"IND_city_culture_lvl3_observatory"	"RigidModels/CampaignBuildings/Textures"	"campaign_building"
"IND_city_culture_lvl4_academy"	"RigidModels/CampaignBuildings/Textures"	"campaign_building"
"IND_city_culture_lvl4_museum"	"RigidModels/CampaignBuildings/Textures"	"campaign_building"
"IND_city_government_lvl1"	"RigidModels/CampaignBuildings/Textures"	"campaign_building"
"IND_city_government_lvl2"	"RigidModels/CampaignBuildings/Textures"	"campaign_building"
"IND_city_government_lvl3"	"RigidModels/CampaignBuildings/Textures"	"campaign_building"
"IND_city_government_lvl4"	"RigidModels/CampaignBuildings/Textures"	"campaign_building"
"IND_city_government_lvl5"	"RigidModels/CampaignBuildings/Textures"	"campaign_building"
"IND_city_government_lvl6"	"RigidModels/CampaignBuildings/Textures"	"campaign_building"
"IND_city_military_lvl1"	"RigidModels/CampaignBuildings/Textures"	"campaign_building"
"IND_city_military_lvl2"	"RigidModels/CampaignBuildings/Textures"	"campaign_building"
"IND_city_military_lvl3"	"RigidModels/CampaignBuildings/Textures"	"campaign_building"
"IND_city_military_lvl4"	"RigidModels/CampaignBuildings/Textures"	"campaign_building"
"IND_city_military_lvl5"	"RigidModels/CampaignBuildings/Textures"	"campaign_building"
"IND_city_naval_lvl1"	"RigidModels/CampaignBuildings/Textures"	"campaign_building"
"IND_city_naval_lvl2"	"RigidModels/CampaignBuildings/Textures"	"campaign_building"
"IND_city_naval_lvl3"	"RigidModels/CampaignBuildings/Textures"	"campaign_building"
"IND_Fort_lvl4"	"RigidModels/CampaignBuildings/Textures"	"campaign_fort"
"IND_Fort_lvl5"	"RigidModels/CampaignBuildings/Textures"	"campaign_fort"
"IND_port_fishing_lvl1"	"RigidModels/CampaignBuildings/Textures"	"campaign_building"
"IND_port_fishing_lvl2"	"RigidModels/CampaignBuildings/Textures"	"campaign_building"
"IND_port_fishing_lvl3"	"RigidModels/CampaignBuildings/Textures"	"campaign_building"
"IND_port_military_lvl1"	"RigidModels/CampaignBuildings/Textures"	"campaign_building"
"IND_port_military_lvl2"	"RigidModels/CampaignBuildings/Textures"	"campaign_building"
"IND_port_military_lvl3"	"RigidModels/CampaignBuildings/Textures"	"campaign_building"
"IND_port_military_lvl4_hospital"	"RigidModels/CampaignBuildings/Textures"	"campaign_building"
"IND_port_military_lvl4_steam"	"RigidModels/CampaignBuildings/Textures"	"campaign_building"
"IND_Port_slot"	"RigidModels/CampaignBuildings/Textures"	"campaign_template"
"IND_Port_slot_minibuildings_wealth1"	"RigidModels/CampaignBuildings/Textures"	"campaign_template_extra"
"IND_Port_slot_minibuildings_wealth2"	"RigidModels/CampaignBuildings/Textures"	"campaign_template_extra"
"IND_Port_slot_minibuildings_wealth3"	"RigidModels/CampaignBuildings/Textures"	"campaign_template_extra"
"IND_Port_slot_minibuildings_wealth4"	"RigidModels/CampaignBuildings/Textures"	"campaign_template_extra"
"IND_Port_slot_minibuildings_wealth5"	"RigidModels/CampaignBuildings/Textures"	"campaign_template_extra"
"IND_port_trade_lvl1"	"RigidModels/CampaignBuildings/Textures"	"campaign_building"
"IND_port_trade_lvl2"	"RigidModels/CampaignBuildings/Textures"	"campaign_building"
"IND_port_trade_lvl3"	"RigidModels/CampaignBuildings/Textures"	"campaign_building"
"IND_port_trade_lvl4"	"RigidModels/CampaignBuildings/Textures"	"campaign_building"
"IND_Port_Village_slot"	"RigidModels/CampaignBuildings/Textures"	"campaign_template"
"IND_resource_farm_lvl5"	"RigidModels/CampaignBuildings/Textures"	"campaign_building"
"IND_resource_farm_lvl5_corn"	"RigidModels/CampaignBuildings/Textures"	"campaign_building"
"IND_resource_farm_lvl5_sheep"	"RigidModels/CampaignBuildings/Textures"	"campaign_building"
"IND_resource_farm_lvl5_wheat"	"RigidModels/CampaignBuildings/Textures"	"campaign_building"
"IND_resource_furtrader_lvl1"	"RigidModels/CampaignBuildings/Textures"	"campaign_building"
"IND_resource_furtrader_lvl2"	"RigidModels/CampaignBuildings/Textures"	"campaign_building"
"IND_resource_furtrader_lvl3"	"RigidModels/CampaignBuildings/Textures"	"campaign_building"
"IND_resource_olives_lvl1"	"RigidModels/CampaignBuildings/Textures"	"campaign_building"
"IND_resource_olives_lvl2"	"RigidModels/CampaignBuildings/Textures"	"campaign_building"
"IND_resource_olives_lvl3"	"RigidModels/CampaignBuildings/Textures"	"campaign_building"
"IND_resource_plantation_coffee_lvl1"	"RigidModels/CampaignBuildings/Textures"	"campaign_building"
"IND_resource_plantation_coffee_lvl2"	"RigidModels/CampaignBuildings/Textures"	"campaign_building"
"IND_resource_plantation_coffee_lvl3"	"RigidModels/CampaignBuildings/Textures"	"campaign_building"
"IND_resource_plantation_cotton_lvl1"	"RigidModels/CampaignBuildings/Textures"	"campaign_building"
"IND_resource_plantation_cotton_lvl2"	"RigidModels/CampaignBuildings/Textures"	"campaign_building"
"IND_resource_plantation_cotton_lvl3"	"RigidModels/CampaignBuildings/Textures"	"campaign_building"
"IND_resource_plantation_spices_lvl1"	"RigidModels/CampaignBuildings/Textures"	"campaign_building"
"IND_resource_plantation_spices_lvl2"	"RigidModels/CampaignBuildings/Textures"	"campaign_building"
"IND_resource_plantation_spices_lvl3"	"RigidModels/CampaignBuildings/Textures"	"campaign_building"
"IND_resource_plantation_sugar_lvl1"	"RigidModels/CampaignBuildings/Textures"	"campaign_building"
"IND_resource_plantation_sugar_lvl2"	"RigidModels/CampaignBuildings/Textures"	"campaign_building"
"IND_resource_plantation_sugar_lvl3"	"RigidModels/CampaignBuildings/Textures"	"campaign_building"
"IND_resource_plantation_tea_lvl1"	"RigidModels/CampaignBuildings/Textures"	"campaign_building"
"IND_resource_plantation_tea_lvl2"	"RigidModels/CampaignBuildings/Textures"	"campaign_building"
"IND_resource_plantation_tea_lvl3"	"RigidModels/CampaignBuildings/Textures"	"campaign_building"
"IND_resource_plantation_tobacco_lvl1"	"RigidModels/CampaignBuildings/Textures"	"campaign_building"
"IND_resource_plantation_tobacco_lvl2"	"RigidModels/CampaignBuildings/Textures"	"campaign_building"
"IND_resource_plantation_tobacco_lvl3"	"RigidModels/CampaignBuildings/Textures"	"campaign_building"
"IND_resource_ricepaddy_lvl1"	"RigidModels/CampaignBuildings/Textures"	"campaign_building"
"IND_resource_ricepaddy_lvl2"	"RigidModels/CampaignBuildings/Textures"	"campaign_building"
"IND_resource_ricepaddy_lvl3"	"RigidModels/CampaignBuildings/Textures"	"campaign_building"
"IND_resource_timber_lvl1"	"RigidModels/CampaignBuildings/Textures"	"campaign_building"
"IND_town_education_lvl1"	"RigidModels/CampaignBuildings/Textures"	"campaign_building"
"IND_town_education_lvl1_religious"	"RigidModels/CampaignBuildings/Textures"	"campaign_building"
"IND_town_education_lvl2_religious"	"RigidModels/CampaignBuildings/Textures"	"campaign_building"
"IND_town_education_lvl2_secular"	"RigidModels/CampaignBuildings/Textures"	"campaign_building"
"IND_town_education_lvl3_religious"	"RigidModels/CampaignBuildings/Textures"	"campaign_building"
"IND_town_education_lvl3_secular"	"RigidModels/CampaignBuildings/Textures"	"campaign_building"
"IND_town_education_lvl4_secular"	"RigidModels/CampaignBuildings/Textures"	"campaign_building"
"IND_town_happy_lvl1"	"RigidModels/CampaignBuildings/Textures"	"campaign_building"
"IND_town_happy_lvl2"	"RigidModels/CampaignBuildings/Textures"	"campaign_building"
"IND_town_happy_lvl3"	"RigidModels/CampaignBuildings/Textures"	"campaign_building"
"IND_town_happy_lvl4"	"RigidModels/CampaignBuildings/Textures"	"campaign_building"
"IND_town_ind_lvl1_metalworks"	"RigidModels/CampaignBuildings/Textures"	"campaign_building"
"IND_town_ind_lvl1_pottery"	"RigidModels/CampaignBuildings/Textures"	"campaign_building"
"IND_town_ind_lvl1_weavers"	"RigidModels/CampaignBuildings/Textures"	"campaign_building"
"IND_town_ind_lvl2_metalworks"	"RigidModels/CampaignBuildings/Textures"	"campaign_building"
"IND_town_ind_lvl2_pottery"	"RigidModels/CampaignBuildings/Textures"	"campaign_building"
"IND_town_ind_lvl2_weavers"	"RigidModels/CampaignBuildings/Textures"	"campaign_building"
"IND_town_ind_lvl3_metalworks"	"RigidModels/CampaignBuildings/Textures"	"campaign_building"
"IND_town_ind_lvl3_pottery"	"RigidModels/CampaignBuildings/Textures"	"campaign_building"
"IND_town_ind_lvl4_pottery"	"RigidModels/CampaignBuildings/Textures"	"campaign_building"
"IND_town_military_lvl1"	"RigidModels/CampaignBuildings/Textures"	"campaign_building"
"IND_town_military_lvl2"	"RigidModels/CampaignBuildings/Textures"	"campaign_building"
"IND_town_military_lvl3"	"RigidModels/CampaignBuildings/Textures"	"campaign_building"
"IND_town_military_lvl4"	"RigidModels/CampaignBuildings/Textures"	"campaign_building"
"IND_town_military_lvl5_artillery"	"RigidModels/CampaignBuildings/Textures"	"campaign_building"
"IND_town_military_lvl5_barracks"	"RigidModels/CampaignBuildings/Textures"	"campaign_building"
"IND_town_military_lvl5_hospital"	"RigidModels/CampaignBuildings/Textures"	"campaign_building"
"IND_town_military_lvl5_stable"	"RigidModels/CampaignBuildings/Textures"	"campaign_building"
"IND_Town_slot"	"RigidModels/CampaignBuildings/Textures"	"campaign_template"
"IND_Town_slot_minibuildings_wealth1"	"RigidModels/CampaignBuildings/Textures"	"campaign_template_extra"
"IND_Town_slot_minibuildings_wealth2"	"RigidModels/CampaignBuildings/Textures"	"campaign_template_extra"
"IND_Town_slot_minibuildings_wealth3"	"RigidModels/CampaignBuildings/Textures"	"campaign_template_extra"
"IND_Town_slot_minibuildings_wealth4"	"RigidModels/CampaignBuildings/Textures"	"campaign_template_extra"
"IND_Town_slot_minibuildings_wealth5"	"RigidModels/CampaignBuildings/Textures"	"campaign_template_extra"
"IND_Town_Village_slot"	"RigidModels/CampaignBuildings/Textures"	"campaign_template"
"indian_church_piece01_destruct01"	"RigidModels\\Buildings\\AAA_TEXTURES"	"battle_building"
"indian_church_piece01_destruct02"	"RigidModels\\Buildings\\AAA_TEXTURES"	"battle_building"
"indian_farmhouse_piece01_destruct01"	"RigidModels\\Buildings\\AAA_TEXTURES"	"battle_building"
"indian_farmhouse_piece01_destruct02"	"RigidModels\\Buildings\\AAA_TEXTURES"	"battle_building"
"indian_farmhouse_piece01_destruct03"	"RigidModels\\Buildings\\AAA_TEXTURES"	"battle_building"
"indian_fort_armoury_piece01_destruct01"	"RigidModels\\Buildings\\AAA_TEXTURES"	"battle_building"
"indian_fort_armoury_piece01_destruct02"	"RigidModels\\Buildings\\AAA_TEXTURES"	"battle_building"
"indian_fort_barracks_piece01_destruct01"	"RigidModels\\Buildings\\AAA_TEXTURES"	"battle_building"
"indian_fort_barracks_piece01_destruct02"	"RigidModels\\Buildings\\AAA_TEXTURES"	"battle_building"
"indian_fort_command_hq_piece01_destruct01"	"RigidModels\\Buildings\\AAA_TEXTURES"	"battle_building"
"indian_fort_command_hq_piece01_destruct02"	"RigidModels\\Buildings\\AAA_TEXTURES"	"battle_building"
"indian_house01_piece01_destruct01"	"RigidModels\\Buildings\\AAA_TEXTURES"	"battle_building"
"indian_house01_piece01_destruct02"	"RigidModels\\Buildings\\AAA_TEXTURES"	"battle_building"
"indian_house01b_piece01_destruct01"	"RigidModels\\Buildings\\AAA_TEXTURES"	"battle_building"
"indian_house01b_piece01_destruct02"	"RigidModels\\Buildings\\AAA_TEXTURES"	"battle_building"
"indian_house02_piece01_destruct01"	"RigidModels\\Buildings\\AAA_TEXTURES"	"battle_building"
"indian_house02_piece01_destruct02"	"RigidModels\\Buildings\\AAA_TEXTURES"	"battle_building"
"indian_house02b_piece01_destruct01"	"RigidModels\\Buildings\\AAA_TEXTURES"	"battle_building"
"indian_house02b_piece01_destruct02"	"RigidModels\\Buildings\\AAA_TEXTURES"	"battle_building"
"indian_house03_piece01_destruct01"	"RigidModels\\Buildings\\AAA_TEXTURES"	"battle_building"
"indian_house03_piece01_destruct02"	"RigidModels\\Buildings\\AAA_TEXTURES"	"battle_building"
"indian_house03b_piece01_destruct01"	"RigidModels\\Buildings\\AAA_TEXTURES"	"battle_building"
"indian_house03b_piece01_destruct02"	"RigidModels\\Buildings\\AAA_TEXTURES"	"battle_building"
"indian_house04_piece01_destruct01"	"RigidModels\\Buildings\\AAA_TEXTURES"	"battle_building"
"indian_house04_piece01_destruct02"	"RigidModels\\Buildings\\AAA_TEXTURES"	"battle_building"
"indian_house04b_piece01_destruct01"	"RigidModels\\Buildings\\AAA_TEXTURES"	"battle_building"
"indian_house04b_piece01_destruct02"	"RigidModels\\Buildings\\AAA_TEXTURES"	"battle_building"
"indian_house05_piece01_destruct01"	"RigidModels\\Buildings\\AAA_TEXTURES"	"battle_building"
"indian_house05_piece01_destruct02"	"RigidModels\\Buildings\\AAA_TEXTURES"	"battle_building"
"indian_house05b_piece01_destruct01"	"RigidModels\\Buildings\\AAA_TEXTURES"	"battle_building"
"indian_house05b_piece01_destruct02"	"RigidModels\\Buildings\\AAA_TEXTURES"	"battle_building"
"indian_house06_piece01_destruct01"	"RigidModels\\Buildings\\AAA_TEXTURES"	"battle_building"
"indian_house06_piece01_destruct02"	"RigidModels\\Buildings\\AAA_TEXTURES"	"battle_building"
"indian_house06b_piece01_destruct01"	"RigidModels\\Buildings\\AAA_TEXTURES"	"battle_building"
"indian_house06b_piece01_destruct02"	"RigidModels\\Buildings\\AAA_TEXTURES"	"battle_building"
"indian_house07_piece01_destruct01"	"RigidModels\\Buildings\\AAA_TEXTURES"	"battle_building"
"indian_house07_piece01_destruct02"	"RigidModels\\Buildings\\AAA_TEXTURES"	"battle_building"
"indian_hut01_piece01_destruct01"	"RigidModels\\Buildings\\AAA_TEXTURES"	"battle_building"
"indian_hut01_piece01_destruct02"	"RigidModels\\Buildings\\AAA_TEXTURES"	"battle_building"
"indian_hut02_piece01_destruct01"	"RigidModels\\Buildings\\AAA_TEXTURES"	"battle_building"
"indian_hut02_piece01_destruct02"	"RigidModels\\Buildings\\AAA_TEXTURES"	"battle_building"
"indian_hut03_piece01_destruct01"	"RigidModels\\Buildings\\AAA_TEXTURES"	"battle_building"
"indian_hut03_piece01_destruct02"	"RigidModels\\Buildings\\AAA_TEXTURES"	"battle_building"
"indian_hut04_piece01_destruct01"	"RigidModels\\Buildings\\AAA_TEXTURES"	"battle_building"
"indian_hut04_piece01_destruct02"	"RigidModels\\Buildings\\AAA_TEXTURES"	"battle_building"
"indian_hut05_piece01_destruct01"	"RigidModels\\Buildings\\AAA_TEXTURES"	"battle_building"
"indian_hut05_piece01_destruct02"	"RigidModels\\Buildings\\AAA_TEXTURES"	"battle_building"
"indian_large_fort_armoury01_piece01_destruct01"	"RigidModels\\Buildings\\AAA_TEXTURES"	"battle_building"
"indian_large_fort_armoury01_piece01_destruct02"	"RigidModels\\Buildings\\AAA_TEXTURES"	"battle_building"
"indian_large_fort_armoury01_piece01_destruct03"	"RigidModels\\Buildings\\AAA_TEXTURES"	"battle_building"
"indian_large_fort_armoury01_piece02_destruct01"	"RigidModels\\Buildings\\AAA_TEXTURES"	"battle_building"
"indian_large_fort_armoury01_piece02_destruct02"	"RigidModels\\Buildings\\AAA_TEXTURES"	"battle_building"
"indian_large_fort_armoury01_piece02_destruct03"	"RigidModels\\Buildings\\AAA_TEXTURES"	"battle_building"
"indian_large_fort_armoury02_piece01_destruct01"	"RigidModels\\Buildings\\AAA_TEXTURES"	"battle_building"
"indian_large_fort_armoury02_piece01_destruct02"	"RigidModels\\Buildings\\AAA_TEXTURES"	"battle_building"
"indian_large_fort_armoury02_piece01_destruct03"	"RigidModels\\Buildings\\AAA_TEXTURES"	"battle_building"
"indian_large_fort_armoury02_piece02_destruct01"	"RigidModels\\Buildings\\AAA_TEXTURES"	"battle_building"
"indian_large_fort_armoury02_piece02_destruct02"	"RigidModels\\Buildings\\AAA_TEXTURES"	"battle_building"
"indian_large_fort_armoury02_piece02_destruct03"	"RigidModels\\Buildings\\AAA_TEXTURES"	"battle_building"
"indian_large_fort_hq_piece01_destruct01"	"RigidModels\\Buildings\\AAA_TEXTURES"	"battle_building"
"indian_large_fort_hq_piece01_destruct02"	"RigidModels\\Buildings\\AAA_TEXTURES"	"battle_building"
"indian_large_fort_hq_piece01_destruct03"	"RigidModels\\Buildings\\AAA_TEXTURES"	"battle_building"
"indian_large_fort_hq_piece02_destruct01"	"RigidModels\\Buildings\\AAA_TEXTURES"	"battle_building"
"indian_large_fort_hq_piece02_destruct02"	"RigidModels\\Buildings\\AAA_TEXTURES"	"battle_building"
"indian_large_fort_hq_piece02_destruct03"	"RigidModels\\Buildings\\AAA_TEXTURES"	"battle_building"
"indian_ruins_piece01_destruct01"	"RigidModels\\Buildings\\AAA_TEXTURES"	"battle_building"
"indian_rural01_piece01_destruct01"	"RigidModels\\Buildings\\AAA_TEXTURES"	"battle_building"
"indian_rural01_piece01_destruct02"	"RigidModels\\Buildings\\AAA_TEXTURES"	"battle_building"
"indian_rural02_piece01_destruct01"	"RigidModels\\Buildings\\AAA_TEXTURES"	"battle_building"
"indian_rural02_piece01_destruct02"	"RigidModels\\Buildings\\AAA_TEXTURES"	"battle_building"
"indian_rural03_piece01_destruct01"	"RigidModels\\Buildings\\AAA_TEXTURES"	"battle_building"
"indian_rural03_piece01_destruct02"	"RigidModels\\Buildings\\AAA_TEXTURES"	"battle_building"
"indian_stone_bridge_piece01_destruct01"	"RigidModels\\Buildings\\AAA_TEXTURES"	"battle_building"
"indian_stone_bridge_piece02_destruct01"	"RigidModels\\Buildings\\AAA_TEXTURES"	"battle_building"
"indian_stone_bridge_piece02_destruct02"	"RigidModels\\Buildings\\AAA_TEXTURES"	"battle_building"
"indian_town_hall_piece01_destruct01"	"RigidModels\\Buildings\\AAA_TEXTURES"	"battle_building"
"indian_town_hall_piece01_destruct02"	"RigidModels\\Buildings\\AAA_TEXTURES"	"battle_building"
"indian_town_hall_piece01_destruct03"	"RigidModels\\Buildings\\AAA_TEXTURES"	"battle_building"
"indian_town_hall_piece02_destruct01"	"RigidModels\\Buildings\\AAA_TEXTURES"	"battle_building"
"indian_town_hall_piece02_destruct02"	"RigidModels\\Buildings\\AAA_TEXTURES"	"battle_building"
"indian_town_hall_piece02_destruct03"	"RigidModels\\Buildings\\AAA_TEXTURES"	"battle_building"
"indian_warehouse01_piece01_destruct01"	"RigidModels\\Buildings\\AAA_TEXTURES"	"battle_building"
"indian_warehouse01_piece01_destruct02"	"RigidModels\\Buildings\\AAA_TEXTURES"	"battle_building"
"indian_warehouse01_piece01_destruct03"	"RigidModels\\Buildings\\AAA_TEXTURES"	"battle_building"
"indian_warehouse01_piece02_destruct01"	"RigidModels\\Buildings\\AAA_TEXTURES"	"battle_building"
"indian_warehouse01_piece02_destruct02"	"RigidModels\\Buildings\\AAA_TEXTURES"	"battle_building"
"indian_warehouse01_piece02_destruct03"	"RigidModels\\Buildings\\AAA_TEXTURES"	"battle_building"
"indian_warehouse01b_piece01_destruct01"	"RigidModels\\Buildings\\AAA_TEXTURES"	"battle_building"
"indian_warehouse01b_piece01_destruct02"	"RigidModels\\Buildings\\AAA_TEXTURES"	"battle_building"
"indian_warehouse01b_piece01_destruct03"	"RigidModels\\Buildings\\AAA_TEXTURES"	"battle_building"
"indian_warehouse02_piece01_destruct01"	"RigidModels\\Buildings\\AAA_TEXTURES"	"battle_building"
"indian_warehouse02_piece01_destruct02"	"RigidModels\\Buildings\\AAA_TEXTURES"	"battle_building"
"indian_warehouse02_piece01_destruct03"	"RigidModels\\Buildings\\AAA_TEXTURES"	"battle_building"
"indian_warehouse02_piece02_destruct01"	"RigidModels\\Buildings\\AAA_TEXTURES"	"battle_building"
"indian_warehouse02_piece02_destruct02"	"RigidModels\\Buildings\\AAA_TEXTURES"	"battle_building"
"indian_warehouse02_piece02_destruct03"	"RigidModels\\Buildings\\AAA_TEXTURES"	"battle_building"
"infantry_proxy"	"RigidModels\\3DIndicators\\Textures"	"3Dindicators"
"jamestown_church_piece01_destruct01"	"RigidModels\\Buildings\\AAA_TEXTURES"	"battle_building"
"jamestown_church_piece01_destruct02"	"RigidModels\\Buildings\\AAA_TEXTURES"	"battle_building"
"jamestown_house01_piece01_destruct01"	"RigidModels\\Buildings\\AAA_TEXTURES"	"battle_building"
"jamestown_house01_piece01_destruct02"	"RigidModels\\Buildings\\AAA_TEXTURES"	"battle_building"
"jamestown_house02_piece01_destruct01"	"RigidModels\\Buildings\\AAA_TEXTURES"	"battle_building"
"jamestown_house02_piece01_destruct02"	"RigidModels\\Buildings\\AAA_TEXTURES"	"battle_building"
"jamestown_townhall_piece01_destruct01"	"RigidModels\\Buildings\\AAA_TEXTURES"	"battle_building"
"jamestown_townhall_piece01_destruct02"	"RigidModels\\Buildings\\AAA_TEXTURES"	"battle_building"
"jamestown_townhall_piece01_destruct03"	"RigidModels\\Buildings\\AAA_TEXTURES"	"battle_building"
"JT_city_1_slot"	"RigidModels/CampaignBuildings/Jamestown/Textures"	"campaign_template_extra"
"JT_city_1_slot_buildings"	"RigidModels/CampaignBuildings/Jamestown/Textures"	"campaign_template_extra"
"JT_city_1_slot_fortifications_lvl0"	"RigidModels/CampaignBuildings/Jamestown/Textures"	"campaign_template_extra"
"JT_city_1_slot_together"	"RigidModels/CampaignBuildings/Jamestown/Textures"	"campaign_template_extra"
"large_log_dry_piece01_destruct01"	"RigidModels\\Buildings\\AAA_TEXTURES"	"battle_building"
"large_log_piece01_destruct01"	"RigidModels\\Buildings\\AAA_TEXTURES"	"battle_building"
"medium_log_dry_piece01_destruct01"	"RigidModels\\Buildings\\AAA_TEXTURES"	"battle_building"
"medium_log_piece01_destruct01"	"RigidModels\\Buildings\\AAA_TEXTURES"	"battle_building"
"mortar_destroyed_model_4inch"	"EngineModels/Textures"	"battle_misc"
"mortar_destroyed_model_8inch"	"EngineModels/Textures"	"battle_misc"
"muzzle_flash"	"RigidModels/Projectile/Textures"	"projectiles"
"NA_campaign_city_1slot_siege"	"RigidModels/CampaignBuildings/SiegeModels/Textures"	"campaign_template_extra"
"NA_campaign_city_4slot_siege"	"RigidModels/CampaignBuildings/SiegeModels/Textures"	"campaign_template_extra"
"NA_City_1_slot"	"RigidModels/CampaignBuildings/Textures"	"campaign_template"
"NA_City_1_slot_minibuildings_wealth1"	"RigidModels/CampaignBuildings/Textures"	"campaign_template_extra"
"NA_City_1_slot_minibuildings_wealth2"	"RigidModels/CampaignBuildings/Textures"	"campaign_template_extra"
"NA_City_1_slot_minibuildings_wealth3"	"RigidModels/CampaignBuildings/Textures"	"campaign_template_extra"
"NA_City_1_slot_minibuildings_wealth4"	"RigidModels/CampaignBuildings/Textures"	"campaign_template_extra"
"NA_City_1_slot_minibuildings_wealth5"	"RigidModels/CampaignBuildings/Textures"	"campaign_template_extra"
"NA_City_4_slot"	"RigidModels/CampaignBuildings/Textures"	"campaign_template"
"NA_City_4_slot_minibuildings_wealth1"	"RigidModels/CampaignBuildings/Textures"	"campaign_template_extra"
"NA_City_4_slot_minibuildings_wealth2"	"RigidModels/CampaignBuildings/Textures"	"campaign_template_extra"
"NA_City_4_slot_minibuildings_wealth3"	"RigidModels/CampaignBuildings/Textures"	"campaign_template_extra"
"NA_City_4_slot_minibuildings_wealth4"	"RigidModels/CampaignBuildings/Textures"	"campaign_template_extra"
"NA_City_4_slot_minibuildings_wealth5"	"RigidModels/CampaignBuildings/Textures"	"campaign_template_extra"
"NA_city_chief_lvl01"	"RigidModels/CampaignBuildings/Textures"	"campaign_building"
"NA_city_chief_lvl02"	"RigidModels/CampaignBuildings/Textures"	"campaign_building"
"NA_city_chief_lvl03"	"RigidModels/CampaignBuildings/Textures"	"campaign_building"
"NA_city_chief_lvl04"	"RigidModels/CampaignBuildings/Textures"	"campaign_building"
"NA_city_market_lvl1"	"RigidModels/CampaignBuildings/Textures"	"campaign_building"
"NA_city_market_lvl2"	"RigidModels/CampaignBuildings/Textures"	"campaign_building"
"NA_city_religious_lvl1"	"RigidModels/CampaignBuildings/Textures"	"campaign_building"
"NA_city_religious_lvl2"	"RigidModels/CampaignBuildings/Textures"	"campaign_building"
"NA_city_religious_lvl3"	"RigidModels/CampaignBuildings/Textures"	"campaign_building"
"NA_Port_slot"	"RigidModels/CampaignBuildings/Textures"	"campaign_template"
"NA_Port_slot_minibuildings_wealth1"	"RigidModels/CampaignBuildings/Textures"	"campaign_template_extra"
"NA_Port_slot_minibuildings_wealth2"	"RigidModels/CampaignBuildings/Textures"	"campaign_template_extra"
"NA_Port_slot_minibuildings_wealth3"	"RigidModels/CampaignBuildings/Textures"	"campaign_template_extra"
"NA_Port_slot_minibuildings_wealth4"	"RigidModels/CampaignBuildings/Textures"	"campaign_template_extra"
"NA_Port_slot_minibuildings_wealth5"	"RigidModels/CampaignBuildings/Textures"	"campaign_template_extra"
"NA_resource_cornfarm_lvl01"	"RigidModels/CampaignBuildings/Textures"	"campaign_building"
"NA_resource_cornfarm_lvl02"	"RigidModels/CampaignBuildings/Textures"	"campaign_building"
"NA_resource_fishery_lvl01"	"RigidModels/CampaignBuildings/Textures"	"campaign_building"
"NA_resource_fishery_lvl02"	"RigidModels/CampaignBuildings/Textures"	"campaign_building"
"NA_resource_openplains_lvl01"	"RigidModels/CampaignBuildings/Textures"	"campaign_building"
"NA_resource_pitmine_lvl1"	"RigidModels/CampaignBuildings/Textures"	"campaign_building"
"NA_resource_plantation_lvl01"	"RigidModels/CampaignBuildings/Textures"	"campaign_building"
"NA_resource_plantation_lvl1_blend "	"RigidModels/CampaignBuildings/Textures"	"campaign_building"
"NA_resource_plantation_lvl1_coffee_blend"	"RigidModels/CampaignBuildings/Textures"	"campaign_building"
"NA_resource_plantation_lvl1_cotton_blend"	"RigidModels/CampaignBuildings/Textures"	"campaign_building"
"NA_resource_plantation_lvl1_spice_blend"	"RigidModels/CampaignBuildings/Textures"	"campaign_building"
"NA_resource_plantation_lvl1_sugar_blend"	"RigidModels/CampaignBuildings/Textures"	"campaign_building"
"NA_resource_plantation_lvl1_tea_blend"	"RigidModels/CampaignBuildings/Textures"	"campaign_building"
"NA_resource_plantation_lvl1_tobacco_blend"	"RigidModels/CampaignBuildings/Textures"	"campaign_building"
"NA_resource_tpost_lvl01"	"RigidModels/CampaignBuildings/Textures"	"campaign_building"
"NA_resource_tpost_lvl02"	"RigidModels/CampaignBuildings/Textures"	"campaign_building"
"NA_resource_wheatfarm_lvl1_blend"	"RigidModels/CampaignBuildings/Textures"	"campaign_building"
"NA_resource_wheatfarm_lvl2_blend"	"RigidModels/CampaignBuildings/Textures"	"campaign_building"
"NA_town_craft_lvl01"	"RigidModels/CampaignBuildings/Textures"	"campaign_building"
"NA_town_craft_lvl02pots"	"RigidModels/CampaignBuildings/Textures"	"campaign_building"
"NA_town_craft_lvl02smithy"	"RigidModels/CampaignBuildings/Textures"	"campaign_building"
"NA_town_craft_lvl02weave"	"RigidModels/CampaignBuildings/Textures"	"campaign_building"
"NA_town_happy_lvl01"	"RigidModels/CampaignBuildings/Textures"	"campaign_building"
"NA_town_happy_lvl02"	"RigidModels/CampaignBuildings/Textures"	"campaign_building"
"NA_town_horse_lvl01"	"RigidModels/CampaignBuildings/Textures"	"campaign_building"
"NA_town_horse_lvl02"	"RigidModels/CampaignBuildings/Textures"	"campaign_building"
"NA_Town_slot"	"RigidModels/CampaignBuildings/Textures"	"campaign_template"
"NA_Town_slot_minibuildings_wealth1"	"RigidModels/CampaignBuildings/Textures"	"campaign_template_extra"
"NA_Town_slot_minibuildings_wealth2"	"RigidModels/CampaignBuildings/Textures"	"campaign_template_extra"
"NA_Town_slot_minibuildings_wealth3"	"RigidModels/CampaignBuildings/Textures"	"campaign_template_extra"
"NA_Town_slot_minibuildings_wealth4"	"RigidModels/CampaignBuildings/Textures"	"campaign_template_extra"
"NA_Town_slot_minibuildings_wealth5"	"RigidModels/CampaignBuildings/Textures"	"campaign_template_extra"
"NA_town_spiritual_lvl01"	"RigidModels/CampaignBuildings/Textures"	"campaign_building"
"NA_town_spiritual_lvl02"	"RigidModels/CampaignBuildings/Textures"	"campaign_building"
"NA_Town_Village_slot"	"RigidModels/CampaignBuildings/Textures"	"campaign_template"
"NA_town_warrior_lvl01"	"RigidModels/CampaignBuildings/Textures"	"campaign_building"
"NA_town_warrior_lvl02"	"RigidModels/CampaignBuildings/Textures"	"campaign_building"
"NA_town_warrior_lvl03"	"RigidModels/CampaignBuildings/Textures"	"campaign_building"
"native_fence_1_piece01_destruct01"	"RigidModels\\BattleFieldProps\\Textures"	"battle_misc"
"native_fence_2_piece01_destruct01"	"RigidModels\\BattleFieldProps\\Textures"	"battle_misc"
"native_fence_4_piece01_destruct01"	"RigidModels\\BattleFieldProps\\Textures"	"battle_misc"
"native_fence_8_piece01_destruct01"	"RigidModels\\BattleFieldProps\\Textures"	"battle_misc"
"native_fence_end_piece01_destruct01"	"RigidModels\\BattleFieldProps\\Textures"	"battle_misc"
"native_house01_piece01_destruct01"	"RigidModels\\Buildings\\AAA_TEXTURES"	"battle_building"
"native_house01_piece01_destruct02"	"RigidModels\\Buildings\\AAA_TEXTURES"	"battle_building"
"native_house02_piece01_destruct01"	"RigidModels\\Buildings\\AAA_TEXTURES"	"battle_building"
"native_house02_piece01_destruct02"	"RigidModels\\Buildings\\AAA_TEXTURES"	"battle_building"
"native_house02b_piece01_destruct01"	"RigidModels\\Buildings\\AAA_TEXTURES"	"battle_building"
"native_house02b_piece01_destruct02"	"RigidModels\\Buildings\\AAA_TEXTURES"	"battle_building"
"native_house03_piece01_destruct01"	"RigidModels\\Buildings\\AAA_TEXTURES"	"battle_building"
"native_house03_piece01_destruct02"	"RigidModels\\Buildings\\AAA_TEXTURES"	"battle_building"
"native_house03b_piece01_destruct01"	"RigidModels\\Buildings\\AAA_TEXTURES"	"battle_building"
"native_house03b_piece01_destruct02"	"RigidModels\\Buildings\\AAA_TEXTURES"	"battle_building"
"native_house04_piece01_destruct01"	"RigidModels\\Buildings\\AAA_TEXTURES"	"battle_building"
"native_house04_piece01_destruct02"	"RigidModels\\Buildings\\AAA_TEXTURES"	"battle_building"
"native_house05_piece01_destruct01"	"RigidModels\\Buildings\\AAA_TEXTURES"	"battle_building"
"native_house05_piece01_destruct02"	"RigidModels\\Buildings\\AAA_TEXTURES"	"battle_building"
"native_house06_piece01_destruct01"	"RigidModels\\Buildings\\AAA_TEXTURES"	"battle_building"
"native_house06_piece01_destruct02"	"RigidModels\\Buildings\\AAA_TEXTURES"	"battle_building"
"native_house07_piece01_destruct01"	"RigidModels\\Buildings\\AAA_TEXTURES"	"battle_building"
"native_house07_piece01_destruct02"	"RigidModels\\Buildings\\AAA_TEXTURES"	"battle_building"
"native_house08_piece01_destruct01"	"RigidModels\\Buildings\\AAA_TEXTURES"	"battle_building"
"native_house08_piece01_destruct02"	"RigidModels\\Buildings\\AAA_TEXTURES"	"battle_building"
"native_house09_piece01_destruct01"	"RigidModels\\Buildings\\AAA_TEXTURES"	"battle_building"
"native_house09_piece01_destruct02"	"RigidModels\\Buildings\\AAA_TEXTURES"	"battle_building"
"native_house10_piece01_destruct01"	"RigidModels\\Buildings\\AAA_TEXTURES"	"battle_building"
"native_house10_piece01_destruct02"	"RigidModels\\Buildings\\AAA_TEXTURES"	"battle_building"
"native_longhouse01_piece01_destruct01"	"RigidModels\\Buildings\\AAA_TEXTURES"	"battle_building"
"native_longhouse01_piece01_destruct02"	"RigidModels\\Buildings\\AAA_TEXTURES"	"battle_building"
"native_longhouse02_piece01_destruct01"	"RigidModels\\Buildings\\AAA_TEXTURES"	"battle_building"
"native_longhouse02_piece01_destruct02"	"RigidModels\\Buildings\\AAA_TEXTURES"	"battle_building"
"native_longhouse03_piece01_destruct01"	"RigidModels\\Buildings\\AAA_TEXTURES"	"battle_building"
"native_longhouse03_piece01_destruct02"	"RigidModels\\Buildings\\AAA_TEXTURES"	"battle_building"
"native_teepee01_piece01_destruct01"	"RigidModels\\Buildings\\AAA_TEXTURES"	"battle_building"
"native_teepee02_piece01_destruct01"	"RigidModels\\Buildings\\AAA_TEXTURES"	"battle_building"
"native_townhall_piece01_destruct01"	"RigidModels\\Buildings\\AAA_TEXTURES"	"battle_building"
"native_townhall_piece01_destruct02"	"RigidModels\\Buildings\\AAA_TEXTURES"	"battle_building"
"Naval_Cannon_destructed"	"EngineModels/Textures"	"battle_misc"
"no_moves_ring"	"RigidModels\\3DIndicators\\Textures"	"3Dindicators"
"north_euro_church_piece01_destruct01"	"RigidModels\\Buildings\\AAA_TEXTURES"	"battle_building"
"north_euro_church_piece01_destruct02"	"RigidModels\\Buildings\\AAA_TEXTURES"	"battle_building"
"north_euro_church02_piece01_destruct01"	"RigidModels\\Buildings\\AAA_TEXTURES"	"battle_building"
"north_euro_church02_piece01_destruct02"	"RigidModels\\Buildings\\AAA_TEXTURES"	"battle_building"
"north_euro_clock_tower_piece01_destruct01"	"RigidModels\\Buildings\\AAA_TEXTURES"	"battle_building"
"north_euro_clock_tower_piece01_destruct02"	"RigidModels\\Buildings\\AAA_TEXTURES"	"battle_building"
"north_euro_house01_piece01_destruct01"	"RigidModels\\Buildings\\AAA_TEXTURES"	"battle_building"
"north_euro_house01_piece01_destruct02"	"RigidModels\\Buildings\\AAA_TEXTURES"	"battle_building"
"north_euro_house01b_piece01_destruct01"	"RigidModels\\Buildings\\AAA_TEXTURES"	"battle_building"
"north_euro_house01b_piece01_destruct02"	"RigidModels\\Buildings\\AAA_TEXTURES"	"battle_building"
"north_euro_house02_piece01_destruct01"	"RigidModels\\Buildings\\AAA_TEXTURES"	"battle_building"
"north_euro_house02_piece01_destruct02"	"RigidModels\\Buildings\\AAA_TEXTURES"	"battle_building"
"north_euro_house02b_piece01_destruct01"	"RigidModels\\Buildings\\AAA_TEXTURES"	"battle_building"
"north_euro_house02b_piece01_destruct02"	"RigidModels\\Buildings\\AAA_TEXTURES"	"battle_building"
"north_euro_house03_piece01_destruct01"	"RigidModels\\Buildings\\AAA_TEXTURES"	"battle_building"
"north_euro_house03_piece01_destruct02"	"RigidModels\\Buildings\\AAA_TEXTURES"	"battle_building"
"north_euro_house03b_piece01_destruct01"	"RigidModels\\Buildings\\AAA_TEXTURES"	"battle_building"
"north_euro_house03b_piece01_destruct02"	"RigidModels\\Buildings\\AAA_TEXTURES"	"battle_building"
"north_euro_house04_piece01_destruct01"	"RigidModels\\Buildings\\AAA_TEXTURES"	"battle_building"
"north_euro_house04_piece01_destruct02"	"RigidModels\\Buildings\\AAA_TEXTURES"	"battle_building"
"north_euro_house04b_piece01_destruct01"	"RigidModels\\Buildings\\AAA_TEXTURES"	"battle_building"
"north_euro_house04b_piece01_destruct02"	"RigidModels\\Buildings\\AAA_TEXTURES"	"battle_building"
"north_euro_house05_piece01_destruct01"	"RigidModels\\Buildings\\AAA_TEXTURES"	"battle_building"
"north_euro_house05_piece01_destruct02"	"RigidModels\\Buildings\\AAA_TEXTURES"	"battle_building"
"north_euro_house05b_piece01_destruct01"	"RigidModels\\Buildings\\AAA_TEXTURES"	"battle_building"
"north_euro_house05b_piece01_destruct02"	"RigidModels\\Buildings\\AAA_TEXTURES"	"battle_building"
"north_euro_house06_piece01_destruct01"	"RigidModels\\Buildings\\AAA_TEXTURES"	"battle_building"
"north_euro_house06_piece01_destruct02"	"RigidModels\\Buildings\\AAA_TEXTURES"	"battle_building"
"north_euro_house06b_piece01_destruct01"	"RigidModels\\Buildings\\AAA_TEXTURES"	"battle_building"
"north_euro_house06b_piece01_destruct02"	"RigidModels\\Buildings\\AAA_TEXTURES"	"battle_building"
"north_euro_house07_piece01_destruct01"	"RigidModels\\Buildings\\AAA_TEXTURES"	"battle_building"
"north_euro_house07_piece01_destruct02"	"RigidModels\\Buildings\\AAA_TEXTURES"	"battle_building"
"north_euro_house07a_piece01_destruct01"	"RigidModels\\Buildings\\AAA_TEXTURES"	"battle_building"
"north_euro_house07a_piece01_destruct02"	"RigidModels\\Buildings\\AAA_TEXTURES"	"battle_building"
"north_euro_house07b_piece01_destruct01"	"RigidModels\\Buildings\\AAA_TEXTURES"	"battle_building"
"north_euro_house07b_piece01_destruct02"	"RigidModels\\Buildings\\AAA_TEXTURES"	"battle_building"
"north_euro_house08_piece01_destruct01"	"RigidModels\\Buildings\\AAA_TEXTURES"	"battle_building"
"north_euro_house08_piece01_destruct02"	"RigidModels\\Buildings\\AAA_TEXTURES"	"battle_building"
"north_euro_house08a_piece01_destruct01"	"RigidModels\\Buildings\\AAA_TEXTURES"	"battle_building"
"north_euro_house08a_piece01_destruct02"	"RigidModels\\Buildings\\AAA_TEXTURES"	"battle_building"
"north_euro_house08b_piece01_destruct01"	"RigidModels\\Buildings\\AAA_TEXTURES"	"battle_building"
"north_euro_house08b_piece01_destruct02"	"RigidModels\\Buildings\\AAA_TEXTURES"	"battle_building"
"north_euro_house08c_piece01_destruct01"	"RigidModels\\Buildings\\AAA_TEXTURES"	"battle_building"
"north_euro_house08c_piece01_destruct02"	"RigidModels\\Buildings\\AAA_TEXTURES"	"battle_building"
"north_euro_house09_piece01_destruct01"	"RigidModels\\Buildings\\AAA_TEXTURES"	"battle_building"
"north_euro_house09_piece01_destruct02"	"RigidModels\\Buildings\\AAA_TEXTURES"	"battle_building"
"north_euro_house09a_piece01_destruct01"	"RigidModels\\Buildings\\AAA_TEXTURES"	"battle_building"
"north_euro_house09a_piece01_destruct02"	"RigidModels\\Buildings\\AAA_TEXTURES"	"battle_building"
"north_euro_house09b_piece01_destruct01"	"RigidModels\\Buildings\\AAA_TEXTURES"	"battle_building"
"north_euro_house09b_piece01_destruct02"	"RigidModels\\Buildings\\AAA_TEXTURES"	"battle_building"
"north_euro_house10_piece01_destruct01"	"RigidModels\\Buildings\\AAA_TEXTURES"	"battle_building"
"north_euro_house10_piece01_destruct02"	"RigidModels\\Buildings\\AAA_TEXTURES"	"battle_building"
"north_euro_house11_piece01_destruct01"	"RigidModels\\Buildings\\AAA_TEXTURES"	"battle_building"
"north_euro_house11_piece01_destruct02"	"RigidModels\\Buildings\\AAA_TEXTURES"	"battle_building"
"north_euro_house11a_piece01_destruct01"	"RigidModels\\Buildings\\AAA_TEXTURES"	"battle_building"
"north_euro_house11a_piece01_destruct02"	"RigidModels\\Buildings\\AAA_TEXTURES"	"battle_building"
"north_euro_house11b_piece01_destruct01"	"RigidModels\\Buildings\\AAA_TEXTURES"	"battle_building"
"north_euro_house11b_piece01_destruct02"	"RigidModels\\Buildings\\AAA_TEXTURES"	"battle_building"
"north_euro_house12_piece01_destruct01"	"RigidModels\\Buildings\\AAA_TEXTURES"	"battle_building"
"north_euro_house12_piece01_destruct02"	"RigidModels\\Buildings\\AAA_TEXTURES"	"battle_building"
"north_euro_house12a_piece01_destruct01"	"RigidModels\\Buildings\\AAA_TEXTURES"	"battle_building"
"north_euro_house12a_piece01_destruct02"	"RigidModels\\Buildings\\AAA_TEXTURES"	"battle_building"
"north_euro_house12b_piece01_destruct01"	"RigidModels\\Buildings\\AAA_TEXTURES"	"battle_building"
"north_euro_house12b_piece01_destruct02"	"RigidModels\\Buildings\\AAA_TEXTURES"	"battle_building"
"north_euro_house12c_piece01_destruct01"	"RigidModels\\Buildings\\AAA_TEXTURES"	"battle_building"
"north_euro_house12c_piece01_destruct02"	"RigidModels\\Buildings\\AAA_TEXTURES"	"battle_building"
"north_euro_house13_piece01_destruct01"	"RigidModels\\Buildings\\AAA_TEXTURES"	"battle_building"
"north_euro_house13_piece01_destruct02"	"RigidModels\\Buildings\\AAA_TEXTURES"	"battle_building"
"north_euro_house13a_piece01_destruct01"	"RigidModels\\Buildings\\AAA_TEXTURES"	"battle_building"
"north_euro_house13a_piece01_destruct02"	"RigidModels\\Buildings\\AAA_TEXTURES"	"battle_building"
"north_euro_hut01_piece01_destruct01"	"RigidModels\\Buildings\\AAA_TEXTURES"	"battle_building"
"north_euro_hut01_piece01_destruct02"	"RigidModels\\Buildings\\AAA_TEXTURES"	"battle_building"
"north_euro_hut02_piece01_destruct01"	"RigidModels\\Buildings\\AAA_TEXTURES"	"battle_building"
"north_euro_hut02_piece01_destruct02"	"RigidModels\\Buildings\\AAA_TEXTURES"	"battle_building"
"north_euro_hut03_piece01_destruct01"	"RigidModels\\Buildings\\AAA_TEXTURES"	"battle_building"
"north_euro_hut03_piece01_destruct02"	"RigidModels\\Buildings\\AAA_TEXTURES"	"battle_building"
"north_euro_hut03_v02_piece01_destruct01"	"RigidModels\\Buildings\\AAA_TEXTURES"	"battle_building"
"north_euro_hut04_piece01_destruct01"	"RigidModels\\Buildings\\AAA_TEXTURES"	"battle_building"
"north_euro_hut04_piece01_destruct02"	"RigidModels\\Buildings\\AAA_TEXTURES"	"battle_building"
"north_euro_hut05_piece01_destruct01"	"RigidModels\\Buildings\\AAA_TEXTURES"	"battle_building"
"north_euro_hut05_piece01_destruct02"	"RigidModels\\Buildings\\AAA_TEXTURES"	"battle_building"
"north_euro_hut06_piece01_destruct01"	"RigidModels\\Buildings\\AAA_TEXTURES"	"battle_building"
"north_euro_hut06_piece01_destruct02"	"RigidModels\\Buildings\\AAA_TEXTURES"	"battle_building"
"north_euro_ruins_piece01_destruct01"	"RigidModels\\Buildings\\AAA_TEXTURES"	"battle_building"
"north_euro_rural01_piece01_destruct01"	"RigidModels\\Buildings\\AAA_TEXTURES"	"battle_building"
"north_euro_rural01_piece01_destruct02"	"RigidModels\\Buildings\\AAA_TEXTURES"	"battle_building"
"north_euro_rural02_piece01_destruct01"	"RigidModels\\Buildings\\AAA_TEXTURES"	"battle_building"
"north_euro_rural02_piece01_destruct02"	"RigidModels\\Buildings\\AAA_TEXTURES"	"battle_building"
"north_euro_rural03_piece01_destruct01"	"RigidModels\\Buildings\\AAA_TEXTURES"	"battle_building"
"north_euro_rural03_piece01_destruct02"	"RigidModels\\Buildings\\AAA_TEXTURES"	"battle_building"
"north_euro_rural04_destruct01"	"RigidModels\\Buildings\\AAA_TEXTURES"	"battle_building"
"north_euro_rural04_destruct02"	"RigidModels\\Buildings\\AAA_TEXTURES"	"battle_building"
"north_euro_rural04_piece01_destruct01"	"RigidModels\\Buildings\\AAA_TEXTURES"	"battle_building"
"north_euro_rural04_piece01_destruct02"	"RigidModels\\Buildings\\AAA_TEXTURES"	"battle_building"
"north_euro_stone_bridge_piece01_destruct01"	"RigidModels\\Buildings\\AAA_TEXTURES"	"battle_building"
"north_euro_stone_bridge_piece02_destruct01"	"RigidModels\\Buildings\\AAA_TEXTURES"	"battle_building"
"north_euro_stone_bridge_piece02_destruct02"	"RigidModels\\Buildings\\AAA_TEXTURES"	"battle_building"
"north_euro_townhall_piece01_destruct01"	"RigidModels\\Buildings\\AAA_TEXTURES"	"battle_building"
"north_euro_townhall_piece01_destruct02"	"RigidModels\\Buildings\\AAA_TEXTURES"	"battle_building"
"north_euro_townhall_piece01_destruct03"	"RigidModels\\Buildings\\AAA_TEXTURES"	"battle_building"
"north_euro_townhall_piece02_destruct01"	"RigidModels\\Buildings\\AAA_TEXTURES"	"battle_building"
"north_euro_townhall_piece02_destruct02"	"RigidModels\\Buildings\\AAA_TEXTURES"	"battle_building"
"north_euro_townhall_piece02_destruct03"	"RigidModels\\Buildings\\AAA_TEXTURES"	"battle_building"
"nwe_euro_ruins01_piece01_destruct01"	"RigidModels\\Buildings\\AAA_TEXTURES"	"battle_building"
"nwe_euro_ruins01_piece01_destruct02"	"RigidModels\\Buildings\\AAA_TEXTURES"	"battle_building"
"nwe_euro_ruins02_piece01_destruct01"	"RigidModels\\Buildings\\AAA_TEXTURES"	"battle_building"
"nwe_euro_ruins02_piece01_destruct02"	"RigidModels\\Buildings\\AAA_TEXTURES"	"battle_building"
"occupiable_building"	"RigidModels\\3DIndicators\\Textures"	"3Dindicators"
"OTT_campaign_city_1slot_siege"	"RigidModels/CampaignBuildings/SiegeModels/Textures"	"campaign_building"
"OTT_campaign_city_5slot_siege"	"RigidModels/CampaignBuildings/SiegeModels/Textures"	"campaign_building"
"OTT_City_1_slot"	"RigidModels/CampaignBuildings/Textures"	"campaign_template"
"OTT_City_1_slot_fortifications"	"RigidModels/CampaignBuildings/Textures"	"campaign_template_extra"
"OTT_City_1_slot_fortifications_lvl0"	"RigidModels/CampaignBuildings/Textures"	"campaign_template"
"OTT_City_1_slot_fortifications_lvl1"	"RigidModels/CampaignBuildings/Textures"	"campaign_template"
"OTT_City_1_slot_fortifications_lvl2"	"RigidModels/CampaignBuildings/Textures"	"campaign_template"
"OTT_City_1_slot_fortified"	"RigidModels/CampaignBuildings/Textures"	"campaign_template_extra"
"OTT_City_1_slot_fortified_minibuildings_wealth1"	"RigidModels/CampaignBuildings/Textures"	"campaign_template_extra"
"OTT_City_1_slot_fortified_minibuildings_wealth2"	"RigidModels/CampaignBuildings/Textures"	"campaign_template_extra"
"OTT_City_1_slot_fortified_minibuildings_wealth3"	"RigidModels/CampaignBuildings/Textures"	"campaign_template_extra"
"OTT_City_1_slot_fortified_minibuildings_wealth4"	"RigidModels/CampaignBuildings/Textures"	"campaign_template_extra"
"OTT_City_1_slot_fortified_minibuildings_wealth5"	"RigidModels/CampaignBuildings/Textures"	"campaign_template_extra"
"OTT_City_1_slot_minibuildings_wealth1"	"RigidModels/CampaignBuildings/Textures"	"campaign_template_extra"
"OTT_City_1_slot_minibuildings_wealth2"	"RigidModels/CampaignBuildings/Textures"	"campaign_template_extra"
"OTT_City_1_slot_minibuildings_wealth3"	"RigidModels/CampaignBuildings/Textures"	"campaign_template_extra"
"OTT_City_1_slot_minibuildings_wealth4"	"RigidModels/CampaignBuildings/Textures"	"campaign_template_extra"
"OTT_City_1_slot_minibuildings_wealth5"	"RigidModels/CampaignBuildings/Textures"	"campaign_template_extra"
"OTT_City_4_slot"	"RigidModels/CampaignBuildings/Textures"	"campaign_template"
"OTT_City_4_slot_fortifications"	"RigidModels/CampaignBuildings/Textures"	"campaign_template_extra"
"OTT_City_4_slot_fortifications_lvl0"	"RigidModels/CampaignBuildings/Textures"	"campaign_template"
"OTT_City_4_slot_fortifications_lvl1"	"RigidModels/CampaignBuildings/Textures"	"campaign_template"
"OTT_City_4_slot_fortifications_lvl2"	"RigidModels/CampaignBuildings/Textures"	"campaign_template"
"OTT_City_4_slot_fortified"	"RigidModels/CampaignBuildings/Textures"	"campaign_template_extra"
"OTT_City_4_slot_fortified_minibuildings_wealth1"	"RigidModels/CampaignBuildings/Textures"	"campaign_template_extra"
"OTT_City_4_slot_fortified_minibuildings_wealth2"	"RigidModels/CampaignBuildings/Textures"	"campaign_template_extra"
"OTT_City_4_slot_fortified_minibuildings_wealth3"	"RigidModels/CampaignBuildings/Textures"	"campaign_template_extra"
"OTT_City_4_slot_fortified_minibuildings_wealth4"	"RigidModels/CampaignBuildings/Textures"	"campaign_template_extra"
"OTT_City_4_slot_fortified_minibuildings_wealth5"	"RigidModels/CampaignBuildings/Textures"	"campaign_template_extra"
"OTT_City_4_slot_minibuildings_wealth1"	"RigidModels/CampaignBuildings/Textures"	"campaign_template_extra"
"OTT_City_4_slot_minibuildings_wealth2"	"RigidModels/CampaignBuildings/Textures"	"campaign_template_extra"
"OTT_City_4_slot_minibuildings_wealth3"	"RigidModels/CampaignBuildings/Textures"	"campaign_template_extra"
"OTT_City_4_slot_minibuildings_wealth4"	"RigidModels/CampaignBuildings/Textures"	"campaign_template_extra"
"OTT_City_4_slot_minibuildings_wealth5"	"RigidModels/CampaignBuildings/Textures"	"campaign_template_extra"
"OTT_City_5_slot"	"RigidModels/CampaignBuildings/Textures"	"campaign_template"
"OTT_City_5_slot_fortifications"	"RigidModels/CampaignBuildings/Textures"	"campaign_template_extra"
"OTT_City_5_slot_fortifications_lvl0"	"RigidModels/CampaignBuildings/Textures"	"campaign_template"
"OTT_City_5_slot_fortifications_lvl1"	"RigidModels/CampaignBuildings/Textures"	"campaign_template"
"OTT_City_5_slot_fortifications_lvl2"	"RigidModels/CampaignBuildings/Textures"	"campaign_template"
"OTT_City_5_slot_fortified"	"RigidModels/CampaignBuildings/Textures"	"campaign_template_extra"
"OTT_City_5_slot_fortified_minibuildings_wealth1"	"RigidModels/CampaignBuildings/Textures"	"campaign_template_extra"
"OTT_City_5_slot_fortified_minibuildings_wealth2"	"RigidModels/CampaignBuildings/Textures"	"campaign_template_extra"
"OTT_City_5_slot_fortified_minibuildings_wealth3"	"RigidModels/CampaignBuildings/Textures"	"campaign_template_extra"
"OTT_City_5_slot_fortified_minibuildings_wealth4"	"RigidModels/CampaignBuildings/Textures"	"campaign_template_extra"
"OTT_City_5_slot_fortified_minibuildings_wealth5"	"RigidModels/CampaignBuildings/Textures"	"campaign_template_extra"
"OTT_City_5_slot_minibuildings_wealth1"	"RigidModels/CampaignBuildings/Textures"	"campaign_template_extra"
"OTT_City_5_slot_minibuildings_wealth2"	"RigidModels/CampaignBuildings/Textures"	"campaign_template_extra"
"OTT_City_5_slot_minibuildings_wealth3"	"RigidModels/CampaignBuildings/Textures"	"campaign_template_extra"
"OTT_City_5_slot_minibuildings_wealth4"	"RigidModels/CampaignBuildings/Textures"	"campaign_template_extra"
"OTT_City_5_slot_minibuildings_wealth5"	"RigidModels/CampaignBuildings/Textures"	"campaign_template_extra"
"OTT_city_artillery_lvl1"	"RigidModels/CampaignBuildings/Textures"	"campaign_building"
"OTT_city_artillery_lvl2"	"RigidModels/CampaignBuildings/Textures"	"campaign_building"
"OTT_city_artillery_lvl3"	"RigidModels/CampaignBuildings/Textures"	"campaign_building"
"OTT_city_artillery_lvl4"	"RigidModels/CampaignBuildings/Textures"	"campaign_building"
"OTT_city_artillery_lvl5"	"RigidModels/CampaignBuildings/Textures"	"campaign_building"
"OTT_city_artillery_lvl6"	"RigidModels/CampaignBuildings/Textures"	"campaign_building"
"OTT_city_culture_lvl1"	"RigidModels/CampaignBuildings/Textures"	"campaign_building"
"OTT_city_culture_lvl2"	"RigidModels/CampaignBuildings/Textures"	"campaign_building"
"OTT_city_culture_lvl3_garden"	"RigidModels/CampaignBuildings/Textures"	"campaign_building"
"OTT_city_culture_lvl3_observatory"	"RigidModels/CampaignBuildings/Textures"	"campaign_building"
"OTT_city_culture_lvl4_academy"	"RigidModels/CampaignBuildings/Textures"	"campaign_building"
"OTT_city_culture_lvl4_museum"	"RigidModels/CampaignBuildings/Textures"	"campaign_building"
"OTT_city_government_lvl1"	"RigidModels/CampaignBuildings/Textures"	"campaign_building"
"OTT_city_government_lvl2"	"RigidModels/CampaignBuildings/Textures"	"campaign_building"
"OTT_city_government_lvl3"	"RigidModels/CampaignBuildings/Textures"	"campaign_building"
"OTT_city_government_lvl4"	"RigidModels/CampaignBuildings/Textures"	"campaign_building"
"OTT_city_government_lvl5"	"RigidModels/CampaignBuildings/Textures"	"campaign_building"
"OTT_city_government_lvl6"	"RigidModels/CampaignBuildings/Textures"	"campaign_building"
"OTT_city_military_lvl1"	"RigidModels/CampaignBuildings/Textures"	"campaign_building"
"OTT_city_military_lvl2"	"RigidModels/CampaignBuildings/Textures"	"campaign_building"
"OTT_city_military_lvl3"	"RigidModels/CampaignBuildings/Textures"	"campaign_building"
"OTT_city_military_lvl4"	"RigidModels/CampaignBuildings/Textures"	"campaign_building"
"OTT_city_military_lvl5"	"RigidModels/CampaignBuildings/Textures"	"campaign_building"
"OTT_city_naval_lvl1"	"RigidModels/CampaignBuildings/Textures"	"campaign_building"
"OTT_city_naval_lvl2"	"RigidModels/CampaignBuildings/Textures"	"campaign_building"
"OTT_city_naval_lvl3"	"RigidModels/CampaignBuildings/Textures"	"campaign_building"
"OTT_Fort_lvl4"	"RigidModels/CampaignBuildings/Textures"	"campaign_fort"
"OTT_Fort_lvl5"	"RigidModels/CampaignBuildings/Textures"	"campaign_fort"
"OTT_port_fishing_lvl1"	"RigidModels/CampaignBuildings/Textures"	"campaign_building"
"OTT_port_fishing_lvl2"	"RigidModels/CampaignBuildings/Textures"	"campaign_building"
"OTT_port_fishing_lvl3"	"RigidModels/CampaignBuildings/Textures"	"campaign_building"
"OTT_port_military_lvl1"	"RigidModels/CampaignBuildings/Textures"	"campaign_building"
"OTT_port_military_lvl2"	"RigidModels/CampaignBuildings/Textures"	"campaign_building"
"OTT_port_military_lvl3"	"RigidModels/CampaignBuildings/Textures"	"campaign_building"
"OTT_port_military_lvl4_hospital"	"RigidModels/CampaignBuildings/Textures"	"campaign_building"
"OTT_port_military_lvl4_steam"	"RigidModels/CampaignBuildings/Textures"	"campaign_building"
"OTT_Port_slot"	"RigidModels/CampaignBuildings/Textures"	"campaign_template_extra"
"OTT_Port_slot_minibuildings_wealth1"	"RigidModels/CampaignBuildings/Textures"	"campaign_template_extra"
"OTT_Port_slot_minibuildings_wealth2"	"RigidModels/CampaignBuildings/Textures"	"campaign_template_extra"
"OTT_Port_slot_minibuildings_wealth3"	"RigidModels/CampaignBuildings/Textures"	"campaign_template_extra"
"OTT_Port_slot_minibuildings_wealth4"	"RigidModels/CampaignBuildings/Textures"	"campaign_template_extra"
"OTT_Port_slot_minibuildings_wealth5"	"RigidModels/CampaignBuildings/Textures"	"campaign_template_extra"
"OTT_port_trade_lvl1"	"RigidModels/CampaignBuildings/Textures"	"campaign_building"
"OTT_port_trade_lvl2"	"RigidModels/CampaignBuildings/Textures"	"campaign_building"
"OTT_port_trade_lvl3"	"RigidModels/CampaignBuildings/Textures"	"campaign_building"
"OTT_port_trade_lvl4"	"RigidModels/CampaignBuildings/Textures"	"campaign_building"
"OTT_Port_Village_slot"	"RigidModels/CampaignBuildings/Textures"	"campaign_template"
"OTT_resource_farm_lvl5"	"RigidModels/CampaignBuildings/Textures"	"campaign_building"
"Ott_resource_farm_lvl5_corn"	"RigidModels/CampaignBuildings/Textures"	"campaign_building"
"Ott_resource_farm_lvl5_sheep"	"RigidModels/CampaignBuildings/Textures"	"campaign_building"
"Ott_resource_farm_lvl5_wheat"	"RigidModels/CampaignBuildings/Textures"	"campaign_building"
"OTT_resource_furtrader_lvl1"	"RigidModels/CampaignBuildings/Textures"	"campaign_building"
"OTT_resource_furtrader_lvl2"	"RigidModels/CampaignBuildings/Textures"	"campaign_building"
"OTT_resource_furtrader_lvl3"	"RigidModels/CampaignBuildings/Textures"	"campaign_building"
"OTT_resource_olives_lvl1"	"RigidModels/CampaignBuildings/Textures"	"campaign_building"
"OTT_resource_olives_lvl2"	"RigidModels/CampaignBuildings/Textures"	"campaign_building"
"OTT_resource_olives_lvl3"	"RigidModels/CampaignBuildings/Textures"	"campaign_building"
"OTT_resource_plantation_coffee_lvl1"	"RigidModels/CampaignBuildings/Textures"	"campaign_building"
"OTT_resource_plantation_coffee_lvl2"	"RigidModels/CampaignBuildings/Textures"	"campaign_building"
"OTT_resource_plantation_coffee_lvl3"	"RigidModels/CampaignBuildings/Textures"	"campaign_building"
"OTT_resource_plantation_cotton_lvl1"	"RigidModels/CampaignBuildings/Textures"	"campaign_building"
"OTT_resource_plantation_cotton_lvl2"	"RigidModels/CampaignBuildings/Textures"	"campaign_building"
"OTT_resource_plantation_cotton_lvl3"	"RigidModels/CampaignBuildings/Textures"	"campaign_building"
"OTT_resource_plantation_spices_lvl1"	"RigidModels/CampaignBuildings/Textures"	"campaign_building"
"OTT_resource_plantation_spices_lvl2"	"RigidModels/CampaignBuildings/Textures"	"campaign_building"
"OTT_resource_plantation_spices_lvl3"	"RigidModels/CampaignBuildings/Textures"	"campaign_building"
"OTT_resource_plantation_sugar_lvl1"	"RigidModels/CampaignBuildings/Textures"	"campaign_building"
"OTT_resource_plantation_sugar_lvl2"	"RigidModels/CampaignBuildings/Textures"	"campaign_building"
"OTT_resource_plantation_sugar_lvl3"	"RigidModels/CampaignBuildings/Textures"	"campaign_building"
"OTT_resource_plantation_tea_lvl1"	"RigidModels/CampaignBuildings/Textures"	"campaign_building"
"OTT_resource_plantation_tea_lvl2"	"RigidModels/CampaignBuildings/Textures"	"campaign_building"
"OTT_resource_plantation_tea_lvl3"	"RigidModels/CampaignBuildings/Textures"	"campaign_building"
"OTT_resource_plantation_tobacco_lvl1"	"RigidModels/CampaignBuildings/Textures"	"campaign_building"
"OTT_resource_plantation_tobacco_lvl2"	"RigidModels/CampaignBuildings/Textures"	"campaign_building"
"OTT_resource_plantation_tobacco_lvl3"	"RigidModels/CampaignBuildings/Textures"	"campaign_building"
"OTT_resource_ricepaddy_lvl1"	"RigidModels/CampaignBuildings/Textures"	"campaign_building"
"OTT_resource_ricepaddy_lvl2"	"RigidModels/CampaignBuildings/Textures"	"campaign_building"
"OTT_resource_ricepaddy_lvl3"	"RigidModels/CampaignBuildings/Textures"	"campaign_building"
"OTT_resource_timber_lvl1"	"RigidModels/CampaignBuildings/Textures"	"campaign_building"
"OTT_town_education_lvl1"	"RigidModels/CampaignBuildings/Textures"	"campaign_building"
"OTT_town_education_lvl1_religious"	"RigidModels/CampaignBuildings/Textures"	"campaign_building"
"OTT_town_education_lvl2_religious"	"RigidModels/CampaignBuildings/Textures"	"campaign_building"
"OTT_town_education_lvl2_secular"	"RigidModels/CampaignBuildings/Textures"	"campaign_building"
"OTT_town_education_lvl3_religious"	"RigidModels/CampaignBuildings/Textures"	"campaign_building"
"OTT_town_education_lvl3_secular"	"RigidModels/CampaignBuildings/Textures"	"campaign_building"
"OTT_town_education_lvl4_secular"	"RigidModels/CampaignBuildings/Textures"	"campaign_building"
"OTT_town_happy_lvl1"	"RigidModels/CampaignBuildings/Textures"	"campaign_building"
"OTT_town_happy_lvl2"	"RigidModels/CampaignBuildings/Textures"	"campaign_building"
"OTT_town_happy_lvl3"	"RigidModels/CampaignBuildings/Textures"	"campaign_building"
"OTT_town_happy_lvl4"	"RigidModels/CampaignBuildings/Textures"	"campaign_building"
"OTT_town_ind_lvl1_metalworks"	"RigidModels/CampaignBuildings/Textures"	"campaign_building"
"OTT_town_ind_lvl1_pottery"	"RigidModels/CampaignBuildings/Textures"	"campaign_building"
"OTT_town_ind_lvl1_weavers"	"RigidModels/CampaignBuildings/Textures"	"campaign_building"
"OTT_town_ind_lvl2_metalworks"	"RigidModels/CampaignBuildings/Textures"	"campaign_building"
"OTT_town_ind_lvl2_pottery"	"RigidModels/CampaignBuildings/Textures"	"campaign_building"
"OTT_town_ind_lvl2_weavers"	"RigidModels/CampaignBuildings/Textures"	"campaign_building"
"OTT_town_ind_lvl3_metalworks"	"RigidModels/CampaignBuildings/Textures"	"campaign_building"
"OTT_town_ind_lvl3_pottery"	"RigidModels/CampaignBuildings/Textures"	"campaign_building"
"OTT_town_ind_lvl4_pottery"	"RigidModels/CampaignBuildings/Textures"	"campaign_building"
"OTT_town_military_lvl1"	"RigidModels/CampaignBuildings/Textures"	"campaign_building"
"OTT_town_military_lvl2"	"RigidModels/CampaignBuildings/Textures"	"campaign_building"
"OTT_town_military_lvl3"	"RigidModels/CampaignBuildings/Textures"	"campaign_building"
"OTT_town_military_lvl4"	"RigidModels/CampaignBuildings/Textures"	"campaign_building"
"OTT_town_military_lvl5_artillery"	"RigidModels/CampaignBuildings/Textures"	"campaign_building"
"OTT_town_military_lvl5_barracks"	"RigidModels/CampaignBuildings/Textures"	"campaign_building"
"OTT_town_military_lvl5_hospital"	"RigidModels/CampaignBuildings/Textures"	"campaign_building"
"OTT_town_military_lvl5_stable"	"RigidModels/CampaignBuildings/Textures"	"campaign_building"
"OTT_Town_slot"	"RigidModels/CampaignBuildings/Textures"	"campaign_template"
"OTT_Town_slot_minibuildings_wealth1"	"RigidModels/CampaignBuildings/Textures"	"campaign_template_extra"
"OTT_Town_slot_minibuildings_wealth2"	"RigidModels/CampaignBuildings/Textures"	"campaign_template_extra"
"OTT_Town_slot_minibuildings_wealth3"	"RigidModels/CampaignBuildings/Textures"	"campaign_template_extra"
"OTT_Town_slot_minibuildings_wealth4"	"RigidModels/CampaignBuildings/Textures"	"campaign_template_extra"
"OTT_Town_slot_minibuildings_wealth5"	"RigidModels/CampaignBuildings/Textures"	"campaign_template_extra"
"OTT_Town_Village_slot"	"RigidModels/CampaignBuildings/Textures"	"campaign_template_extra"
"ottoman_farmhouse_piece01_destruct01"	"RigidModels\\Buildings\\AAA_TEXTURES"	"battle_building"
"ottoman_farmhouse_piece01_destruct02"	"RigidModels\\Buildings\\AAA_TEXTURES"	"battle_building"
"ottoman_farmhouse_piece01_destruct03"	"RigidModels\\Buildings\\AAA_TEXTURES"	"battle_building"
"ottoman_field_cannon_destroyed_model_12lb"	"EngineModels/Textures"	"battle_misc"
"ottoman_field_cannon_destroyed_model_18lb"	"EngineModels/Textures"	"battle_misc"
"ottoman_field_cannon_destroyed_model_24lb"	"EngineModels/Textures"	"battle_misc"
"ottoman_field_cannon_destroyed_model_32lb"	"EngineModels/Textures"	"battle_misc"
"ottoman_field_cannon_destroyed_model_3lb"	"EngineModels/Textures"	"battle_misc"
"ottoman_field_cannon_destroyed_model_9lb"	"EngineModels/Textures"	"battle_misc"
"ottoman_fort_armoury_piece01_destruct01"	"RigidModels\\Buildings\\AAA_TEXTURES"	"battle_building"
"ottoman_fort_armoury_piece01_destruct02"	"RigidModels\\Buildings\\AAA_TEXTURES"	"battle_building"
"ottoman_fort_command_hq_piece01_destruct01"	"RigidModels\\Buildings\\AAA_TEXTURES"	"battle_building"
"ottoman_fort_command_hq_piece01_destruct02"	"RigidModels\\Buildings\\AAA_TEXTURES"	"battle_building"
"ottoman_house01_piece01_destruct01"	"RigidModels\\Buildings\\AAA_TEXTURES"	"battle_building"
"ottoman_house01_piece01_destruct02"	"RigidModels\\Buildings\\AAA_TEXTURES"	"battle_building"
"ottoman_house01b_piece01_destruct01"	"RigidModels\\Buildings\\AAA_TEXTURES"	"battle_building"
"ottoman_house01b_piece01_destruct02"	"RigidModels\\Buildings\\AAA_TEXTURES"	"battle_building"
"ottoman_house02_piece01_destruct01"	"RigidModels\\Buildings\\AAA_TEXTURES"	"battle_building"
"ottoman_house02_piece01_destruct02"	"RigidModels\\Buildings\\AAA_TEXTURES"	"battle_building"
"ottoman_house02b_piece01_destruct01"	"RigidModels\\Buildings\\AAA_TEXTURES"	"battle_building"
"ottoman_house02b_piece01_destruct02"	"RigidModels\\Buildings\\AAA_TEXTURES"	"battle_building"
"ottoman_house03_piece01_destruct01"	"RigidModels\\Buildings\\AAA_TEXTURES"	"battle_building"
"ottoman_house03_piece01_destruct02"	"RigidModels\\Buildings\\AAA_TEXTURES"	"battle_building"
"ottoman_house03b_piece01_destruct01"	"RigidModels\\Buildings\\AAA_TEXTURES"	"battle_building"
"ottoman_house03b_piece01_destruct02"	"RigidModels\\Buildings\\AAA_TEXTURES"	"battle_building"
"ottoman_house04_piece01_destruct01"	"RigidModels\\Buildings\\AAA_TEXTURES"	"battle_building"
"ottoman_house04_piece01_destruct02"	"RigidModels\\Buildings\\AAA_TEXTURES"	"battle_building"
"ottoman_house04b_piece01_destruct01"	"RigidModels\\Buildings\\AAA_TEXTURES"	"battle_building"
"ottoman_house04b_piece01_destruct02"	"RigidModels\\Buildings\\AAA_TEXTURES"	"battle_building"
"ottoman_house05_piece01_destruct01"	"RigidModels\\Buildings\\AAA_TEXTURES"	"battle_building"
"ottoman_house05_piece01_destruct02"	"RigidModels\\Buildings\\AAA_TEXTURES"	"battle_building"
"ottoman_house05b_piece01_destruct01"	"RigidModels\\Buildings\\AAA_TEXTURES"	"battle_building"
"ottoman_house05b_piece01_destruct02"	"RigidModels\\Buildings\\AAA_TEXTURES"	"battle_building"
"ottoman_house06_piece01_destruct01"	"RigidModels\\Buildings\\AAA_TEXTURES"	"battle_building"
"ottoman_house06_piece01_destruct02"	"RigidModels\\Buildings\\AAA_TEXTURES"	"battle_building"
"ottoman_house06b_piece01_destruct01"	"RigidModels\\Buildings\\AAA_TEXTURES"	"battle_building"
"ottoman_house06b_piece01_destruct02"	"RigidModels\\Buildings\\AAA_TEXTURES"	"battle_building"
"ottoman_house07_piece01_destruct01"	"RigidModels\\Buildings\\AAA_TEXTURES"	"battle_building"
"ottoman_house07_piece01_destruct02"	"RigidModels\\Buildings\\AAA_TEXTURES"	"battle_building"
"ottoman_howitzer_destroyed_model_12lb"	"EngineModels/Textures"	"battle_misc"
"ottoman_howitzer_destroyed_model_24lb"	"EngineModels/Textures"	"battle_misc"
"ottoman_hut01_piece01_destruct01"	"RigidModels\\Buildings\\AAA_TEXTURES"	"battle_building"
"ottoman_hut01_piece01_destruct02"	"RigidModels\\Buildings\\AAA_TEXTURES"	"battle_building"
"ottoman_hut02_piece01_destruct01"	"RigidModels\\Buildings\\AAA_TEXTURES"	"battle_building"
"ottoman_hut02_piece01_destruct02"	"RigidModels\\Buildings\\AAA_TEXTURES"	"battle_building"
"ottoman_hut03_piece01_destruct01"	"RigidModels\\Buildings\\AAA_TEXTURES"	"battle_building"
"ottoman_hut03_piece01_destruct02"	"RigidModels\\Buildings\\AAA_TEXTURES"	"battle_building"
"ottoman_hut04_piece01_destruct01"	"RigidModels\\Buildings\\AAA_TEXTURES"	"battle_building"
"ottoman_hut04_piece01_destruct02"	"RigidModels\\Buildings\\AAA_TEXTURES"	"battle_building"
"ottoman_hut05_piece01_destruct01"	"RigidModels\\Buildings\\AAA_TEXTURES"	"battle_building"
"ottoman_hut05_piece01_destruct02"	"RigidModels\\Buildings\\AAA_TEXTURES"	"battle_building"
"ottoman_hut06_piece01_destruct01"	"RigidModels\\Buildings\\AAA_TEXTURES"	"battle_building"
"ottoman_hut06_piece01_destruct02"	"RigidModels\\Buildings\\AAA_TEXTURES"	"battle_building"
"ottoman_large_fort_armoury01_piece01_destruct01"	"RigidModels\\Buildings\\AAA_TEXTURES"	"battle_building"
"ottoman_large_fort_armoury01_piece01_destruct02"	"RigidModels\\Buildings\\AAA_TEXTURES"	"battle_building"
"ottoman_large_fort_armoury01_piece01_destruct03"	"RigidModels\\Buildings\\AAA_TEXTURES"	"battle_building"
"ottoman_large_fort_armoury01_piece02_destruct01"	"RigidModels\\Buildings\\AAA_TEXTURES"	"battle_building"
"ottoman_large_fort_armoury01_piece02_destruct02"	"RigidModels\\Buildings\\AAA_TEXTURES"	"battle_building"
"ottoman_large_fort_armoury01_piece02_destruct03"	"RigidModels\\Buildings\\AAA_TEXTURES"	"battle_building"
"ottoman_large_fort_armoury02_piece01_destruct01"	"RigidModels\\Buildings\\AAA_TEXTURES"	"battle_building"
"ottoman_large_fort_armoury02_piece01_destruct02"	"RigidModels\\Buildings\\AAA_TEXTURES"	"battle_building"
"ottoman_large_fort_armoury02_piece01_destruct03"	"RigidModels\\Buildings\\AAA_TEXTURES"	"battle_building"
"ottoman_large_fort_barracks_piece01_destruct01"	"RigidModels\\Buildings\\AAA_TEXTURES"	"battle_building"
"ottoman_large_fort_barracks_piece01_destruct02"	"RigidModels\\Buildings\\AAA_TEXTURES"	"battle_building"
"ottoman_large_fort_barracks_piece01_destruct03"	"RigidModels\\Buildings\\AAA_TEXTURES"	"battle_building"
"ottoman_large_fort_command_hq_piece01_destruct01"	"RigidModels\\Buildings\\AAA_TEXTURES"	"battle_building"
"ottoman_large_fort_command_hq_piece01_destruct02"	"RigidModels\\Buildings\\AAA_TEXTURES"	"battle_building"
"ottoman_large_fort_command_hq_piece01_destruct03"	"RigidModels\\Buildings\\AAA_TEXTURES"	"battle_building"
"ottoman_large_fort_command_hq_piece02_destruct01"	"RigidModels\\Buildings\\AAA_TEXTURES"	"battle_building"
"ottoman_large_fort_command_hq_piece02_destruct02"	"RigidModels\\Buildings\\AAA_TEXTURES"	"battle_building"
"ottoman_large_fort_command_hq_piece02_destruct03"	"RigidModels\\Buildings\\AAA_TEXTURES"	"battle_building"
"ottoman_large_fort_command_hq_piece03_destruct01"	"RigidModels\\Buildings\\AAA_TEXTURES"	"battle_building"
"ottoman_large_fort_command_hq_piece03_destruct02"	"RigidModels\\Buildings\\AAA_TEXTURES"	"battle_building"
"ottoman_large_fort_command_hq_piece03_destruct03"	"RigidModels\\Buildings\\AAA_TEXTURES"	"battle_building"
"ottoman_mortar_destroyed_model_4inch"	"EngineModels/Textures"	"battle_misc"
"ottoman_mortar_destroyed_model_8inch"	"EngineModels/Textures"	"battle_misc"
"ottoman_organ_gun_destroyed_model"	"EngineModels/Textures"	"battle_misc"
"ottoman_ruins_piece01_destruct01"	"RigidModels\\Buildings\\AAA_TEXTURES"	"battle_building"
"ottoman_ruins01_piece01_destruct01"	"RigidModels\\Buildings\\AAA_TEXTURES"	"battle_building"
"ottoman_ruins01_piece01_destruct02"	"RigidModels\\Buildings\\AAA_TEXTURES"	"battle_building"
"ottoman_rural01_piece01_destruct01"	"RigidModels\\Buildings\\AAA_TEXTURES"	"battle_building"
"ottoman_rural01_piece01_destruct02"	"RigidModels\\Buildings\\AAA_TEXTURES"	"battle_building"
"ottoman_rural02_piece01_destruct01"	"RigidModels\\Buildings\\AAA_TEXTURES"	"battle_building"
"ottoman_rural02_piece01_destruct02"	"RigidModels\\Buildings\\AAA_TEXTURES"	"battle_building"
"ottoman_rural03_piece01_destruct01"	"RigidModels\\Buildings\\AAA_TEXTURES"	"battle_building"
"ottoman_rural03_piece01_destruct02"	"RigidModels\\Buildings\\AAA_TEXTURES"	"battle_building"
"ottoman_stone_bridge_piece01_destruct01"	"RigidModels\\Buildings\\AAA_TEXTURES"	"battle_building"
"ottoman_stone_bridge_piece02_destruct01"	"RigidModels\\Buildings\\AAA_TEXTURES"	"battle_building"
"ottoman_stone_bridge_piece02_destruct02"	"RigidModels\\Buildings\\AAA_TEXTURES"	"battle_building"
"ottoman_townhall_piece01_destruct01"	"RigidModels\\Buildings\\AAA_TEXTURES"	"battle_building"
"ottoman_townhall_piece01_destruct02"	"RigidModels\\Buildings\\AAA_TEXTURES"	"battle_building"
"ottoman_townhall_piece01_destruct03"	"RigidModels\\Buildings\\AAA_TEXTURES"	"battle_building"
"ottoman_townhall_piece02_destruct01"	"RigidModels\\Buildings\\AAA_TEXTURES"	"battle_building"
"ottoman_townhall_piece02_destruct02"	"RigidModels\\Buildings\\AAA_TEXTURES"	"battle_building"
"ottoman_townhall_piece02_destruct03"	"RigidModels\\Buildings\\AAA_TEXTURES"	"battle_building"
"ottoman_townhall_piece03_destruct01"	"RigidModels\\Buildings\\AAA_TEXTURES"	"battle_building"
"ottoman_townhall_piece03_destruct02"	"RigidModels\\Buildings\\AAA_TEXTURES"	"battle_building"
"ottoman_townhall_piece03_destruct03"	"RigidModels\\Buildings\\AAA_TEXTURES"	"battle_building"
"ottoman_warehouse04_piece01_destruct01"	"RigidModels\\Buildings\\AAA_TEXTURES"	"battle_building"
"ottoman_warehouse04_piece01_destruct02"	"RigidModels\\Buildings\\AAA_TEXTURES"	"battle_building"
"ottoman_warehouse04_piece01_destruct03"	"RigidModels\\Buildings\\AAA_TEXTURES"	"battle_building"
"ottoman_warehouse04_piece02_destruct01"	"RigidModels\\Buildings\\AAA_TEXTURES"	"battle_building"
"ottoman_warehouse04_piece02_destruct02"	"RigidModels\\Buildings\\AAA_TEXTURES"	"battle_building"
"ottoman_warehouse04_piece02_destruct03"	"RigidModels\\Buildings\\AAA_TEXTURES"	"battle_building"
"ottoman_warehouse04_piece03_destruct01"	"RigidModels\\Buildings\\AAA_TEXTURES"	"battle_building"
"ottoman_warehouse04_piece03_destruct02"	"RigidModels\\Buildings\\AAA_TEXTURES"	"battle_building"
"ottoman_warehouse04_piece03_destruct03"	"RigidModels\\Buildings\\AAA_TEXTURES"	"battle_building"
"positional_bigrailA_L01"	"RigidModels/Naval/Textures"	"ship_variant"
"positional_capstanA_L01"	"RigidModels/Naval/Textures"	"ship_variant"
"positional_capstanA_L02"	"RigidModels/Naval/Textures"	"ship_variant"
"positional_figurehead_L01"	"RigidModels/Naval/Textures"	"ship_variant"
"positional_lanternA_L01"	"RigidModels/Naval/Textures"	"ship_variant"
"positional_lanternA_L02"	"RigidModels/Naval/Textures"	"ship_variant"
"positional_oar_L01"	"RigidModels/Naval/Textures"	"ship_variant"
"positional_oar_L02"	"RigidModels/Naval/Textures"	"ship_variant"
"positional_oar_L03"	"RigidModels/Naval/Textures"	"ship_variant"
"positional_postsA_L01"	"RigidModels/Naval/Textures"	"ship_variant"
"positional_sparA_L01"	"RigidModels/Naval/Textures"	"ship_variant"
"positional_sparA_L02"	"RigidModels/Naval/Textures"	"ship_variant"
"positional_wheelA_L01"	"RigidModels/Naval/Textures"	"ship_variant"
"prestige_ajinkyatara"	"RigidModels/CampaignBuildings/Textures"	"campaign_building"
"prestige_albertina"	"RigidModels/CampaignBuildings/Textures"	"campaign_building"
"Prestige_Arcdetriomphe"	"RigidModels/CampaignBuildings/Textures"	"campaign_building"
"Prestige_berlinacademy"	"RigidModels/CampaignBuildings/Textures"	"campaign_building"
"Prestige_blenheimpalace"	"RigidModels/CampaignBuildings/Textures"	"campaign_building"
"Prestige_bourbon"	"RigidModels/CampaignBuildings/Textures"	"campaign_building"
"Prestige_brandenburg"	"RigidModels/CampaignBuildings/Textures"	"campaign_building"
"prestige_britishmuseum"	"RigidModels/CampaignBuildings/Textures"	"campaign_building"
"Prestige_capitol"	"RigidModels/CampaignBuildings/Textures"	"campaign_building"
"Prestige_dezwaan"	"RigidModels/CampaignBuildings/Textures"	"campaign_building"
"Prestige_granja"	"RigidModels/CampaignBuildings/Textures"	"campaign_building"
"Prestige_hofburg"	"RigidModels/CampaignBuildings/Textures"	"campaign_building"
"prestige_independancehall"	"RigidModels/CampaignBuildings/Textures"	"campaign_building"
"Prestige_kaerlskirche"	"RigidModels/CampaignBuildings/Textures"	"campaign_building"
"Prestige_konglig"	"RigidModels/CampaignBuildings/Textures"	"campaign_building"
"prestige_konikjlijke"	"RigidModels/CampaignBuildings/Textures"	"campaign_building"
"Prestige_kunstkamara"	"RigidModels/CampaignBuildings/Textures"	"campaign_building"
"Prestige_lazienki"	"RigidModels/CampaignBuildings/Textures"	"campaign_building"
"Prestige_ledreborg"	"RigidModels/CampaignBuildings/Textures"	"campaign_building"
"Prestige_NavalEngineer"	"RigidModels/CampaignBuildings/Textures"	"campaign_building"
"Prestige_osmaniye"	"RigidModels/CampaignBuildings/Textures"	"campaign_building"
"Prestige_palaciomadrid"	"RigidModels/CampaignBuildings/Textures"	"campaign_building"
"Prestige_polishakademia"	"RigidModels/CampaignBuildings/Textures"	"campaign_building"
"prestige_realacademia"	"RigidModels/CampaignBuildings/Textures"	"campaign_building"
"Prestige_Rogalinpalace"	"RigidModels/CampaignBuildings/Textures"	"campaign_building"
"prestige_shaniwarwada"	"RigidModels/CampaignBuildings/Textures"	"campaign_building"
"prestige_smithsonian"	"RigidModels/CampaignBuildings/Textures"	"campaign_building"
"Prestige_somersethouse"	"RigidModels/CampaignBuildings/Textures"	"campaign_building"
"prestige_stockholmslott"	"RigidModels/CampaignBuildings/Textures"	"campaign_building"
"Prestige_swedishacademy"	"RigidModels/CampaignBuildings/Textures"	"campaign_building"
"Prestige_teylersmuseum"	"RigidModels/CampaignBuildings/Textures"	"campaign_building"
"Prestige_whitehouse"	"RigidModels/CampaignBuildings/Textures"	"campaign_building"
"Prestige_winterpalace"	"RigidModels/CampaignBuildings/Textures"	"campaign_building"
"projectile_arrow"	"UnitModels/Textures"	"projectiles"
"projectile_cannonbal"	"UnitModels/Textures"	"projectiles"
"projectile_chainshot01"	"UnitModels/Textures"	"projectiles"
"projectile_chainshot02"	"UnitModels/Textures"	"projectiles"
"projectile_fragment01"	"UnitModels/Textures"	"projectiles"
"projectile_grapeshot"	"UnitModels/Textures"	"projectiles"
"projectile_grenade"	"UnitModels/Textures"	"projectiles"
"projectile_musketball"	"UnitModels/Textures"	"projectiles"
"projectile_rocket"	"UnitModels\\textures"	"projectiles"
"projectile_tomahawk"	"UnitModels/Textures"	"projectiles"
"prop_field_applebarrels_piece01_destruct01"	"RigidModels\\Buildings\\AAA_TEXTURES"	"battle_building"
"prop_field_cart_piece01_destruct01"	"RigidModels\\Buildings\\AAA_TEXTURES"	"battle_building"
"prop_field_fallen_oak_log01_piece01_destruct01"	"RigidModels\\Buildings\\AAA_TEXTURES"	"battle_building"
"prop_field_fallen_oak_log01_piece01_destruct02"	"RigidModels\\Buildings\\AAA_TEXTURES"	"battle_building"
"prop_field_fallen_oak_log02_piece01_destruct01"	"RigidModels\\Buildings\\AAA_TEXTURES"	"battle_building"
"prop_field_fallen_oak_log02_piece01_destruct02"	"RigidModels\\Buildings\\AAA_TEXTURES"	"battle_building"
"prop_field_fallen_oak_log03_piece01_destruct01"	"RigidModels\\Buildings\\AAA_TEXTURES"	"battle_building"
"prop_field_fallen_oak_log03_piece01_destruct02"	"RigidModels\\Buildings\\AAA_TEXTURES"	"battle_building"
"prop_field_fallen_pine_tree01_piece01_destruct01"	"RigidModels\\Buildings\\AAA_TEXTURES"	"battle_building"
"prop_field_fallen_pine_tree01_piece01_destruct02"	"RigidModels\\Buildings\\AAA_TEXTURES"	"battle_building"
"prop_field_fallen_pine_tree02_piece01_destruct01"	"RigidModels\\Buildings\\AAA_TEXTURES"	"battle_building"
"prop_field_fallen_pine_tree02_piece01_destruct02"	"RigidModels\\Buildings\\AAA_TEXTURES"	"battle_building"
"prop_field_fallen_pine_tree03_piece01_destruct01"	"RigidModels\\Buildings\\AAA_TEXTURES"	"battle_building"
"prop_field_fallen_pine_tree03_piece01_destruct02"	"RigidModels\\Buildings\\AAA_TEXTURES"	"battle_building"
"prop_field_fire_pit_piece01_destruct01"	"RigidModels\\Buildings\\AAA_TEXTURES"	"battle_building"
"prop_field_fire_pit_piece01_destruct02"	"RigidModels\\Buildings\\AAA_TEXTURES"	"battle_building"
"prop_field_haybale_bundle01_piece01_destruct01"	"RigidModels\\Buildings\\AAA_TEXTURES"	"battle_building"
"prop_field_haybale_bundle02_piece01_destruct01"	"RigidModels\\Buildings\\AAA_TEXTURES"	"battle_building"
"prop_field_haybale_bundle03_piece01_destruct01"	"RigidModels\\Buildings\\AAA_TEXTURES"	"battle_building"
"prop_field_haybale_piece01_destruct01"	"RigidModels\\Buildings\\AAA_TEXTURES"	"battle_building"
"prop_field_haysheaf_alpahtest_piece01_destruct01"	"RigidModels\\Buildings\\AAA_TEXTURES"	"battle_building"
"prop_field_haysheaf_piece01_destruct01"	"RigidModels\\Buildings\\AAA_TEXTURES"	"battle_building"
"prop_field_log_pile01_piece01_destruct01"	"RigidModels\\Buildings\\AAA_TEXTURES"	"battle_building"
"prop_field_log_pile01_piece01_destruct02"	"RigidModels\\Buildings\\AAA_TEXTURES"	"battle_building"
"prop_field_log_pile02_piece01_destruct01"	"RigidModels\\Buildings\\AAA_TEXTURES"	"battle_building"
"prop_field_log_pile02_piece01_destruct02"	"RigidModels\\Buildings\\AAA_TEXTURES"	"battle_building"
"prop_field_log_pile03_piece01_destruct01"	"RigidModels\\Buildings\\AAA_TEXTURES"	"battle_building"
"prop_field_log_pile03_piece01_destruct02"	"RigidModels\\Buildings\\AAA_TEXTURES"	"battle_building"
"prop_field_stepladder_piece01_destruct01"	"RigidModels\\Buildings\\AAA_TEXTURES"	"battle_building"
"prop_field_tent_large_piece01_destruct01"	"RigidModels\\Buildings\\AAA_TEXTURES"	"battle_building"
"prop_field_tent_med_piece01_destruct01"	"RigidModels\\Buildings\\AAA_TEXTURES"	"battle_building"
"prop_field_tent_small_piece01_destruct01"	"RigidModels\\Buildings\\AAA_TEXTURES"	"battle_building"
"prop_field_treestump_large_piece01_destruct01"	"RigidModels\\Buildings\\AAA_TEXTURES"	"battle_building"
"prop_field_treestump_piece01_destruct01"	"RigidModels\\Buildings\\AAA_TEXTURES"	"battle_building"
"prop_field_treestump_small_piece01_destruct01"	"RigidModels\\Buildings\\AAA_TEXTURES"	"battle_building"
"prop_field_trough_piece01_destruct01"	"RigidModels\\Buildings\\AAA_TEXTURES"	"battle_building"
"prop_field_wagon_covered_piece01_destruct01"	"RigidModels\\Buildings\\AAA_TEXTURES"	"battle_building"
"prop_field_wagon_covered_piece01_destruct02"	"RigidModels\\Buildings\\AAA_TEXTURES"	"battle_building"
"prop_field_wagon_uncovered_piece01_destruct01"	"RigidModels\\Buildings\\AAA_TEXTURES"	"battle_building"
"prop_field_wagon_uncovered_piece01_destruct02"	"RigidModels\\Buildings\\AAA_TEXTURES"	"battle_building"
"prop_field_wheat_bundle_piece01_destruct01"	"RigidModels\\Buildings\\prop_field_wheat_bundle"	"battle_building"
"prop_field_wheelbarrow_piece01_destruct01"	"RigidModels\\Buildings\\AAA_TEXTURES"	"battle_building"
"prop_town_fire_pit_piece01_destruct01"	"RigidModels\\Buildings\\AAA_TEXTURES"	"battle_building"
"prop_town_fire_pit_piece01_destruct02"	"RigidModels\\Buildings\\AAA_TEXTURES"	"battle_building"
"prop_town_flagpole_piece01_destruct01"	"RigidModels\\Buildings\\AAA_TEXTURES"	"battle_building"
"prop_town_flagpole_piece01_destruct02"	"RigidModels\\Buildings\\AAA_TEXTURES"	"battle_building"
"prop_town_food_baskets_piece01_destruct01"	"RigidModels\\Buildings\\AAA_TEXTURES"	"battle_building"
"prop_town_food_baskets_piece01_destruct02"	"RigidModels\\Buildings\\AAA_TEXTURES"	"battle_building"
"prop_town_gravestone01_piece01_destruct01"	"RigidModels\\Buildings\\AAA_TEXTURES"	"battle_building"
"prop_town_gravestone01_piece01_destruct02"	"RigidModels\\Buildings\\AAA_TEXTURES"	"battle_building"
"prop_town_gravestone02_piece01_destruct01"	"RigidModels\\Buildings\\AAA_TEXTURES"	"battle_building"
"prop_town_gravestone02_piece01_destruct02"	"RigidModels\\Buildings\\AAA_TEXTURES"	"battle_building"
"prop_town_gravestone03_piece01_destruct01"	"RigidModels\\Buildings\\AAA_TEXTURES"	"battle_building"
"prop_town_gravestone03_piece01_destruct02"	"RigidModels\\Buildings\\AAA_TEXTURES"	"battle_building"
"prop_town_market_stall01_piece01_destruct01"	"RigidModels\\Buildings\\AAA_TEXTURES"	"battle_building"
"prop_town_market_stall01_piece01_destruct02"	"RigidModels\\Buildings\\AAA_TEXTURES"	"battle_building"
"prop_town_market_stall02_piece01_destruct01"	"RigidModels\\Buildings\\AAA_TEXTURES"	"battle_building"
"prop_town_market_stall02_piece01_destruct02"	"RigidModels\\Buildings\\AAA_TEXTURES"	"battle_building"
"prop_town_market_stall03_piece01_destruct01"	"RigidModels\\Buildings\\AAA_TEXTURES"	"battle_building"
"prop_town_market_stall03_piece01_destruct02"	"RigidModels\\Buildings\\AAA_TEXTURES"	"battle_building"
"prop_town_market_stall04_piece01_destruct01"	"RigidModels\\Buildings\\AAA_TEXTURES"	"battle_building"
"prop_town_market_stall04_piece01_destruct02"	"RigidModels\\Buildings\\AAA_TEXTURES"	"battle_building"
"prop_town_market_stall05_piece01_destruct01"	"RigidModels\\Buildings\\AAA_TEXTURES"	"battle_building"
"prop_town_market_stall05_piece01_destruct02"	"RigidModels\\Buildings\\AAA_TEXTURES"	"battle_building"
"prop_town_native_totempole01_piece01_destruct01"	"RigidModels\\Buildings\\AAA_TEXTURES"	"battle_building"
"prop_town_native_totempole01_piece01_destruct02"	"RigidModels\\Buildings\\AAA_TEXTURES"	"battle_building"
"prop_town_ott_stall04_piece01_destruct01"	"RigidModels\\Buildings\\AAA_TEXTURES"	"battle_building"
"prop_town_ott_stall04_piece01_destruct02"	"RigidModels\\Buildings\\AAA_TEXTURES"	"battle_building"
"prop_town_ott_stall05_piece01_destruct01"	"RigidModels\\Buildings\\AAA_TEXTURES"	"battle_building"
"prop_town_ott_stall05_piece01_destruct02"	"RigidModels\\Buildings\\AAA_TEXTURES"	"battle_building"
"prop_town_ott_stall06_piece01_destruct01"	"RigidModels\\Buildings\\AAA_TEXTURES"	"battle_building"
"prop_town_ott_stall06_piece01_destruct02"	"RigidModels\\Buildings\\AAA_TEXTURES"	"battle_building"
"prop_town_ottoman_food_baskets_piece01_destruct01"	"RigidModels\\Buildings\\AAA_TEXTURES"	"battle_building"
"prop_town_ottoman_food_baskets_piece01_destruct02"	"RigidModels\\Buildings\\AAA_TEXTURES"	"battle_building"
"prop_town_ottoman_pagoda_piece01_destruct01"	"RigidModels\\Buildings\\AAA_TEXTURES"	"battle_building"
"prop_town_ottoman_pagoda_piece01_destruct02"	"RigidModels\\Buildings\\AAA_TEXTURES"	"battle_building"
"prop_town_ottoman_stall01_piece01_destruct01"	"RigidModels\\Buildings\\AAA_TEXTURES"	"battle_building"
"prop_town_ottoman_stall01_piece01_destruct02"	"RigidModels\\Buildings\\AAA_TEXTURES"	"battle_building"
"prop_town_ottoman_stall02_piece01_destruct01"	"RigidModels\\Buildings\\AAA_TEXTURES"	"battle_building"
"prop_town_ottoman_stall02_piece01_destruct02"	"RigidModels\\Buildings\\AAA_TEXTURES"	"battle_building"
"prop_town_ottoman_stall03_piece01_destruct01"	"RigidModels\\Buildings\\AAA_TEXTURES"	"battle_building"
"prop_town_ottoman_stall03_piece01_destruct02"	"RigidModels\\Buildings\\AAA_TEXTURES"	"battle_building"
"prop_town_ottoman_stone_bench_piece01_destruct01"	"RigidModels\\Buildings\\AAA_TEXTURES"	"battle_building"
"prop_town_ottoman_stone_bench_piece01_destruct02"	"RigidModels\\Buildings\\AAA_TEXTURES"	"battle_building"
"prop_town_pile_of_stones_piece01_destruct01"	"RigidModels\\Buildings\\AAA_TEXTURES"	"battle_building"
"prop_town_pile_of_stones_piece01_destruct02"	"RigidModels\\Buildings\\AAA_TEXTURES"	"battle_building"
"prop_town_plant_pot01_piece01_destruct01"	"RigidModels\\Buildings\\AAA_TEXTURES"	"battle_building"
"prop_town_plant_pot01_piece01_destruct02"	"RigidModels\\Buildings\\AAA_TEXTURES"	"battle_building"
"prop_town_plant_pot02_piece01_destruct01"	"RigidModels\\Buildings\\AAA_TEXTURES"	"battle_building"
"prop_town_plant_pot02_piece01_destruct02"	"RigidModels\\Buildings\\AAA_TEXTURES"	"battle_building"
"prop_town_plant_pot03_piece01_destruct01"	"RigidModels\\Buildings\\AAA_TEXTURES"	"battle_building"
"prop_town_plant_pot03_piece01_destruct02"	"RigidModels\\Buildings\\AAA_TEXTURES"	"battle_building"
"prop_town_pulley_piece01_destruct01"	"RigidModels\\Buildings\\AAA_TEXTURES"	"battle_building"
"prop_town_pulley_piece01_destruct02"	"RigidModels\\Buildings\\AAA_TEXTURES"	"battle_building"
"prop_town_scaffolding_piece01_destruct01"	"RigidModels\\Buildings\\AAA_TEXTURES"	"battle_building"
"prop_town_scaffolding_piece01_destruct02"	"RigidModels\\Buildings\\AAA_TEXTURES"	"battle_building"
"prop_town_signpost_piece01_destruct01"	"RigidModels\\Buildings\\AAA_TEXTURES"	"battle_building"
"prop_town_signpost_piece01_destruct02"	"RigidModels\\Buildings\\AAA_TEXTURES"	"battle_building"
"prop_town_stack_of_barrels_piece01_destruct01"	"RigidModels\\Buildings\\AAA_TEXTURES"	"battle_building"
"prop_town_stack_of_barrels_piece01_destruct02"	"RigidModels\\Buildings\\AAA_TEXTURES"	"battle_building"
"prop_town_stack_of_trunks_piece01_destruct01"	"RigidModels\\Buildings\\AAA_TEXTURES"	"battle_building"
"prop_town_stack_of_trunks_piece01_destruct02"	"RigidModels\\Buildings\\AAA_TEXTURES"	"battle_building"
"prop_town_stone_bench_piece01_destruct01"	"RigidModels\\Buildings\\AAA_TEXTURES"	"battle_building"
"prop_town_stone_bench_piece01_destruct02"	"RigidModels\\Buildings\\AAA_TEXTURES"	"battle_building"
"prop_town_stone_pillar_piece01_destruct01"	"RigidModels\\Buildings\\AAA_TEXTURES"	"battle_building"
"prop_town_stone_pillar_piece01_destruct02"	"RigidModels\\Buildings\\AAA_TEXTURES"	"battle_building"
"prop_town_street_lamp_piece01_destruct01"	"RigidModels\\Buildings\\AAA_TEXTURES"	"battle_building"
"prop_town_street_lamp_piece01_destruct02"	"RigidModels\\Buildings\\AAA_TEXTURES"	"battle_building"
"prop_town_urn01_piece01_destruct01"	"RigidModels\\Buildings\\AAA_TEXTURES"	"battle_building"
"prop_town_urn01_piece01_destruct02"	"RigidModels\\Buildings\\AAA_TEXTURES"	"battle_building"
"prop_town_urn02_piece01_destruct01"	"RigidModels\\Buildings\\AAA_TEXTURES"	"battle_building"
"prop_town_urn02_piece01_destruct02"	"RigidModels\\Buildings\\AAA_TEXTURES"	"battle_building"
"prop_town_urn03_piece01_destruct01"	"RigidModels\\Buildings\\AAA_TEXTURES"	"battle_building"
"prop_town_urn03_piece01_destruct02"	"RigidModels\\Buildings\\AAA_TEXTURES"	"battle_building"
"prop_town_wicker_baskets_piece01_destruct01"	"RigidModels\\Buildings\\AAA_TEXTURES"	"battle_building"
"prop_town_wicker_baskets_piece01_destruct02"	"RigidModels\\Buildings\\AAA_TEXTURES"	"battle_building"
"prop_town_wooden_bench_piece01_destruct01"	"RigidModels\\Buildings\\AAA_TEXTURES"	"battle_building"
"prop_town_wooden_bench_piece01_destruct02"	"RigidModels\\Buildings\\AAA_TEXTURES"	"battle_building"
"prop_town_wooden_boards_piece01_destruct01"	"RigidModels\\Buildings\\AAA_TEXTURES"	"battle_building"
"prop_town_wooden_boards_piece01_destruct02"	"RigidModels\\Buildings\\AAA_TEXTURES"	"battle_building"
"prop_town_wooden_pole_piece01_destruct01"	"RigidModels\\Buildings\\AAA_TEXTURES"	"battle_building"
"prop_town_wooden_pole_piece01_destruct02"	"RigidModels\\Buildings\\AAA_TEXTURES"	"battle_building"
"prop_town_wooden_shack_piece01_destruct01"	"RigidModels\\Buildings\\AAA_TEXTURES"	"battle_building"
"prop_town_wooden_shack_piece01_destruct02"	"RigidModels\\Buildings\\AAA_TEXTURES"	"battle_building"
"prop_town_woodenstructure_piece01_destruct01"	"RigidModels\\Buildings\\AAA_TEXTURES"	"battle_building"
"prop_town_woodenstructure_piece01_destruct02"	"RigidModels\\Buildings\\AAA_TEXTURES"	"battle_building"
"redoubt_marker"	"RigidModels\\WarscapeFrame\\ai_hints\\Textures"	"3Dindicators"
"river_sound_emitter_marker"	"RigidModels\\WarscapeFrame\\sound_emitters\\textures"	"3Dindicators"
"rock_1_dry_piece01_destruct01"	"RigidModels\\Buildings\\AAA_TEXTURES"	"battle_building"
"rock_1_wet_piece01_destruct01"	"RigidModels\\Buildings\\AAA_TEXTURES"	"battle_building"
"rock_2_dry_piece01_destruct01"	"RigidModels\\Buildings\\AAA_TEXTURES"	"battle_building"
"rock_2_wet_piece01_destruct01"	"RigidModels\\Buildings\\AAA_TEXTURES"	"battle_building"
"rock_3_dry_piece01_destruct01"	"RigidModels\\Buildings\\AAA_TEXTURES"	"battle_building"
"rock_3_wet_piece01_destruct01"	"RigidModels\\Buildings\\AAA_TEXTURES"	"battle_building"
"rock_4_dry_piece01_destruct01"	"RigidModels\\Buildings\\AAA_TEXTURES"	"battle_building"
"rock_4_wet_piece01_destruct01"	"RigidModels\\Buildings\\AAA_TEXTURES"	"battle_building"
"rocket_destructed_model"	"EngineModels/Textures"	"battle_misc"
"ruinedchurch_piece01_destruct01"	"RigidModels\\Buildings\\AAA_TEXTURES"	"battle_building"
"ruins_piece01_destruct01"	"RigidModels\\Buildings\\AAA_TEXTURES"	"battle_building"
"sea_debris_v01"	"RigidModels/Naval/Textures"	"sea_wreck"
"ship_debris_02"	"RigidModels/Naval/Textures"	"sea_wreck"
"ship_debris_03"	"RigidModels/Naval/Textures"	"sea_wreck"
"ship_debris_04"	"RigidModels/Naval/Textures"	"sea_wreck"
"ship_debris_05"	"RigidModels/Naval/Textures"	"sea_wreck"
"ship_debris_06"	"RigidModels/Naval/Textures"	"sea_wreck"
"ship_debris_07"	"RigidModels/Naval/Textures"	"sea_wreck"
"ship_debris_08"	"RigidModels/Naval/Textures"	"sea_wreck"
"ship_debris_09"	"RigidModels/Naval/Textures"	"sea_wreck"
"ship_debris_10"	"RigidModels/Naval/Textures"	"sea_wreck"
"ship_debris_11"	"RigidModels/Naval/Textures"	"sea_wreck"
"siege_prop_flagpole"	"RigidModels/VerletItems/textures"	"battle_misc"
"Slot_resource_farm_corn"	"RigidModels/CampaignBuildings/Textures"	"campaign_building"
"Slot_resource_farm_wheat"	"RigidModels/CampaignBuildings/Textures"	"campaign_building"
"slot_resource_furtrader"	"RigidModels/CampaignBuildings/Textures"	"campaign_building"
"slot_resource_mining_gems_lvl0"	"RigidModels/CampaignBuildings/Textures"	"campaign_building"
"slot_resource_mining_gold_lvl0"	"RigidModels/CampaignBuildings/Textures"	"campaign_building"
"slot_resource_mining_iron_lvl0"	"RigidModels/CampaignBuildings/Textures"	"campaign_building"
"slot_resource_mining_silver_lvl0"	"RigidModels/CampaignBuildings/Textures"	"campaign_building"
"Slot_resource_plantation_caribbean"	"RigidModels/CampaignBuildings/Textures"	"campaign_building"
"Slot_resource_plantation_cuba"	"RigidModels/CampaignBuildings/Textures"	"campaign_building"
"Slot_resource_plantation_egypt"	"RigidModels/CampaignBuildings/Textures"	"campaign_building"
"Slot_resource_plantation_india_highlands"	"RigidModels/CampaignBuildings/Textures"	"campaign_building"
"Slot_resource_plantation_southern_usa"	"RigidModels/CampaignBuildings/Textures"	"campaign_building"
"Slot_resource_plantation_tropical_humid"	"RigidModels/CampaignBuildings/Textures"	"campaign_building"
"slot_resource_ricepaddy"	"RigidModels/CampaignBuildings/Textures"	"campaign_building"
"slot_resource_timber"	"RigidModels/CampaignBuildings/Textures"	"campaign_building"
"slot_resource_vineyards"	"RigidModels/CampaignBuildings/Textures"	"campaign_building"
"small_log_dry_piece01_destruct01"	"RigidModels\\Buildings\\AAA_TEXTURES"	"battle_building"
"small_log_piece01_destruct01"	"RigidModels\\Buildings\\AAA_TEXTURES"	"battle_building"
"small_rock_1_piece01_destruct01"	"RigidModels\\Buildings\\AAA_TEXTURES"	"battle_building"
"small_rock_2_piece01_destruct01"	"RigidModels\\Buildings\\AAA_TEXTURES"	"battle_building"
"small_rock_3_piece01_destruct01"	"RigidModels\\Buildings\\AAA_TEXTURES"	"battle_building"
"small_rock_4_piece01_destruct01"	"RigidModels\\Buildings\\AAA_TEXTURES"	"battle_building"
"south_euro_church_piece01_destruct01"	"RigidModels\\Buildings\\AAA_TEXTURES"	"battle_building"
"south_euro_church_piece01_destruct02"	"RigidModels\\Buildings\\AAA_TEXTURES"	"battle_building"
"south_euro_farmhouse_piece01_destruct01"	"RigidModels\\Buildings\\AAA_TEXTURES"	"battle_building"
"south_euro_farmhouse_piece01_destruct02"	"RigidModels\\Buildings\\AAA_TEXTURES"	"battle_building"
"south_euro_farmhouse_piece01_destruct03"	"RigidModels\\Buildings\\AAA_TEXTURES"	"battle_building"
"south_euro_house01_piece01_destruct01"	"RigidModels\\Buildings\\AAA_TEXTURES"	"battle_building"
"south_euro_house01_piece01_destruct02"	"RigidModels\\Buildings\\AAA_TEXTURES"	"battle_building"
"south_euro_house01b_piece01_destruct01"	"RigidModels\\Buildings\\AAA_TEXTURES"	"battle_building"
"south_euro_house01b_piece01_destruct02"	"RigidModels\\Buildings\\AAA_TEXTURES"	"battle_building"
"south_euro_house02_piece01_destruct01"	"RigidModels\\Buildings\\AAA_TEXTURES"	"battle_building"
"south_euro_house02_piece01_destruct02"	"RigidModels\\Buildings\\AAA_TEXTURES"	"battle_building"
"south_euro_house03_piece01_destruct01"	"RigidModels\\Buildings\\AAA_TEXTURES"	"battle_building"
"south_euro_house03_piece01_destruct02"	"RigidModels\\Buildings\\AAA_TEXTURES"	"battle_building"
"south_euro_house03b_piece01_destruct01"	"RigidModels\\Buildings\\AAA_TEXTURES"	"battle_building"
"south_euro_house03b_piece01_destruct02"	"RigidModels\\Buildings\\AAA_TEXTURES"	"battle_building"
"south_euro_house04_piece01_destruct01"	"RigidModels\\Buildings\\AAA_TEXTURES"	"battle_building"
"south_euro_house04_piece01_destruct02"	"RigidModels\\Buildings\\AAA_TEXTURES"	"battle_building"
"south_euro_house04b_piece01_destruct01"	"RigidModels\\Buildings\\AAA_TEXTURES"	"battle_building"
"south_euro_house04b_piece01_destruct02"	"RigidModels\\Buildings\\AAA_TEXTURES"	"battle_building"
"south_euro_house05_piece01_destruct01"	"RigidModels\\Buildings\\AAA_TEXTURES"	"battle_building"
"south_euro_house05_piece01_destruct02"	"RigidModels\\Buildings\\AAA_TEXTURES"	"battle_building"
"south_euro_house05b_piece01_destruct01"	"RigidModels\\Buildings\\AAA_TEXTURES"	"battle_building"
"south_euro_house05b_piece01_destruct02"	"RigidModels\\Buildings\\AAA_TEXTURES"	"battle_building"
"south_euro_house06_piece01_destruct01"	"RigidModels\\Buildings\\AAA_TEXTURES"	"battle_building"
"south_euro_house06_piece01_destruct02"	"RigidModels\\Buildings\\AAA_TEXTURES"	"battle_building"
"south_euro_house06b_piece01_destruct01"	"RigidModels\\Buildings\\AAA_TEXTURES"	"battle_building"
"south_euro_house06b_piece01_destruct02"	"RigidModels\\Buildings\\AAA_TEXTURES"	"battle_building"
"south_euro_house07_piece01_destruct01"	"RigidModels\\Buildings\\AAA_TEXTURES"	"battle_building"
"south_euro_house07_piece01_destruct02"	"RigidModels\\Buildings\\AAA_TEXTURES"	"battle_building"
"south_euro_house08_piece01_destruct01"	"RigidModels\\Buildings\\AAA_TEXTURES"	"battle_building"
"south_euro_house08_piece01_destruct02"	"RigidModels\\Buildings\\AAA_TEXTURES"	"battle_building"
"south_euro_house08b_piece01_destruct01"	"RigidModels\\Buildings\\AAA_TEXTURES"	"battle_building"
"south_euro_house08b_piece01_destruct02"	"RigidModels\\Buildings\\AAA_TEXTURES"	"battle_building"
"south_euro_house09_piece01_destruct01"	"RigidModels\\Buildings\\AAA_TEXTURES"	"battle_building"
"south_euro_house09_piece01_destruct02"	"RigidModels\\Buildings\\AAA_TEXTURES"	"battle_building"
"south_euro_house09b_piece01_destruct01"	"RigidModels\\Buildings\\AAA_TEXTURES"	"battle_building"
"south_euro_house09b_piece01_destruct02"	"RigidModels\\Buildings\\AAA_TEXTURES"	"battle_building"
"south_euro_house10_piece01_destruct01"	"RigidModels\\Buildings\\AAA_TEXTURES"	"battle_building"
"south_euro_house10_piece01_destruct02"	"RigidModels\\Buildings\\AAA_TEXTURES"	"battle_building"
"south_euro_house10_piece02_destruct01"	"RigidModels\\Buildings\\AAA_TEXTURES"	"battle_building"
"south_euro_house10b_piece01_destruct01"	"RigidModels\\Buildings\\AAA_TEXTURES"	"battle_building"
"south_euro_house10b_piece01_destruct02"	"RigidModels\\Buildings\\AAA_TEXTURES"	"battle_building"
"south_euro_house10b_piece02_destruct01"	"RigidModels\\Buildings\\AAA_TEXTURES"	"battle_building"
"south_euro_hut01_piece01_destruct01"	"RigidModels\\Buildings\\AAA_TEXTURES"	"battle_building"
"south_euro_hut01_piece01_destruct02"	"RigidModels\\Buildings\\AAA_TEXTURES"	"battle_building"
"south_euro_hut02_piece01_destruct01"	"RigidModels\\Buildings\\AAA_TEXTURES"	"battle_building"
"south_euro_hut02_piece01_destruct02"	"RigidModels\\Buildings\\AAA_TEXTURES"	"battle_building"
"south_euro_hut03_piece01_destruct01"	"RigidModels\\Buildings\\AAA_TEXTURES"	"battle_building"
"south_euro_hut03_piece01_destruct02"	"RigidModels\\Buildings\\AAA_TEXTURES"	"battle_building"
"south_euro_hut04_piece01_destruct01"	"RigidModels\\Buildings\\AAA_TEXTURES"	"battle_building"
"south_euro_hut04_piece01_destruct02"	"RigidModels\\Buildings\\AAA_TEXTURES"	"battle_building"
"south_euro_hut05_piece01_destruct01"	"RigidModels\\Buildings\\AAA_TEXTURES"	"battle_building"
"south_euro_hut05_piece01_destruct02"	"RigidModels\\Buildings\\AAA_TEXTURES"	"battle_building"
"south_euro_ruins_piece01_destruct01"	"RigidModels\\Buildings\\AAA_TEXTURES"	"battle_building"
"south_euro_ruins_piece01_destruct02"	"RigidModels\\Buildings\\AAA_TEXTURES"	"battle_building"
"south_euro_rural01_piece01_destruct01"	"RigidModels\\Buildings\\AAA_TEXTURES"	"battle_building"
"south_euro_rural01_piece01_destruct02"	"RigidModels\\Buildings\\AAA_TEXTURES"	"battle_building"
"south_euro_rural02_piece01_destruct01"	"RigidModels\\Buildings\\AAA_TEXTURES"	"battle_building"
"south_euro_rural02_piece01_destruct02"	"RigidModels\\Buildings\\AAA_TEXTURES"	"battle_building"
"south_euro_rural03_piece01_destruct01"	"RigidModels\\Buildings\\AAA_TEXTURES"	"battle_building"
"south_euro_rural03_piece01_destruct02"	"RigidModels\\Buildings\\AAA_TEXTURES"	"battle_building"
"south_euro_rural04_piece01_destruct01"	"RigidModels\\Buildings\\AAA_TEXTURES"	"battle_building"
"south_euro_rural04_piece01_destruct02"	"RigidModels\\Buildings\\AAA_TEXTURES"	"battle_building"
"south_euro_stone_bridge_piece01_destruct01"	"RigidModels\\Buildings\\AAA_TEXTURES"	"battle_building"
"south_euro_stone_bridge_piece02_destruct01"	"RigidModels\\Buildings\\AAA_TEXTURES"	"battle_building"
"south_euro_stone_bridge_piece02_destruct02"	"RigidModels\\Buildings\\AAA_TEXTURES"	"battle_building"
"south_euro_townhall_piece01_destruct01"	"RigidModels\\Buildings\\AAA_TEXTURES"	"battle_building"
"south_euro_townhall_piece01_destruct02"	"RigidModels\\Buildings\\AAA_TEXTURES"	"battle_building"
"south_euro_townhall_piece01_destruct03"	"RigidModels\\Buildings\\AAA_TEXTURES"	"battle_building"
"south_euro_townhall_piece02_destruct01"	"RigidModels\\Buildings\\AAA_TEXTURES"	"battle_building"
"south_euro_townhall_piece02_destruct02"	"RigidModels\\Buildings\\AAA_TEXTURES"	"battle_building"
"south_euro_townhall_piece02_destruct03"	"RigidModels\\Buildings\\AAA_TEXTURES"	"battle_building"
"south_euro_townhall02_piece01_destruct01"	"RigidModels\\Buildings\\AAA_TEXTURES"	"battle_building"
"south_euro_windmill_piece01_destruct01"	"RigidModels\\Buildings\\AAA_TEXTURES"	"battle_building"
"south_euro_windmill_piece01_destruct02"	"RigidModels\\Buildings\\AAA_TEXTURES"	"battle_building"
"star_fort_armoury_v2_piece01_destruct01"	"RigidModels\\Buildings\\AAA_TEXTURES"	"battle_building"
"star_fort_armoury_v2_piece01_destruct02"	"RigidModels\\Buildings\\AAA_TEXTURES"	"battle_building"
"star_fort_barracks_v2_piece01_destruct01"	"RigidModels\\Buildings\\AAA_TEXTURES"	"battle_building"
"star_fort_barracks_v2_piece01_destruct02"	"RigidModels\\Buildings\\AAA_TEXTURES"	"battle_building"
"star_fort_command_hq_piece01_destruct01"	"RigidModels\\Buildings\\AAA_TEXTURES"	"battle_building"
"star_fort_command_hq_piece01_destruct02"	"RigidModels\\Buildings\\AAA_TEXTURES"	"battle_building"
"strat_selector"	"RigidModels\\3DIndicators\\Textures"	"3Dindicators"
"strat_selector_enemy"	"RigidModels\\3DIndicators\\Textures"	"3Dindicators"
"suitable_deployable_item_chevaux_de_frise_marker"	"RigidModels\\WarscapeFrame\\ai_hints\\Textures"	"3Dindicators"
"suitable_deployable_item_earthworks_marker"	"RigidModels\\WarscapeFrame\\ai_hints\\Textures"	"3Dindicators"
"suitable_deployable_item_fougasse_marker"	"RigidModels\\WarscapeFrame\\ai_hints\\Textures"	"3Dindicators"
"suitable_deployable_item_gabionade_marker"	"RigidModels\\WarscapeFrame\\ai_hints\\Textures"	"3Dindicators"
"suitable_ground_bombardment_marker"	"RigidModels\\WarscapeFrame\\ai_hints\\Textures"	"3Dindicators"
"town_cluster_marker"	"RigidModels\\WarscapeFrame\\ai_hints\\Textures"	"3Dindicators"
"transit_africaE"	"RigidModels\\CampaignBuildings\\CampaignProps\\Textures"	"campaign_transition_markers"
"transit_africaW"	"RigidModels\\CampaignBuildings\\CampaignProps\\Textures"	"campaign_transition_markers"
"transit_brazil"	"RigidModels\\CampaignBuildings\\CampaignProps\\Textures"	"campaign_transition_markers"
"transit_Eindies"	"RigidModels\\CampaignBuildings\\CampaignProps\\Textures"	"campaign_transition_markers"
"transit_eu"	"RigidModels\\CampaignBuildings\\CampaignProps\\Textures"	"campaign_transition_markers"
"transit_india"	"RigidModels\\CampaignBuildings\\CampaignProps\\Textures"	"campaign_transition_markers"
"transit_usa"	"RigidModels\\CampaignBuildings\\CampaignProps\\Textures"	"campaign_transition_markers"
"trash"	"RigidModels\\Buildings\\AAA_TEXTURES"	"battle_building"
"trash_d02"	"RigidModels\\Buildings\\AAA_TEXTURES"	"battle_building"
"tree_stump_and_log_dry_piece01_destruct01"	"RigidModels\\Buildings\\AAA_TEXTURES"	"battle_building"
"tree_stump_and_log_piece01_destruct01"	"RigidModels\\Buildings\\AAA_TEXTURES"	"battle_building"
"tree_stump_dry_piece01_destruct01"	"RigidModels\\Buildings\\AAA_TEXTURES"	"battle_building"
"tree_stump_piece01_destruct01"	"RigidModels\\Buildings\\AAA_TEXTURES"	"battle_building"
"trees"	"RigidModels/Vegetation/CampaignTrees/Textures"	"campaign_trees"
"Wall_Asia_End_piece01_destruct01"	"RigidModels\\BattleFieldProps\\Textures"	"battle_misc"
"wall_end_piece01_destruct01"	"RigidModels\\BattleFieldProps\\Textures"	"battle_misc"
"Wall_EU_East_End_piece01_destruct01"	"RigidModels\\BattleFieldProps\\Textures"	"battle_misc"
"Wall_EU_North_End_piece01_destruct01"	"RigidModels\\BattleFieldProps\\Textures"	"battle_misc"
"Wall_EU_South_End_piece01_destruct01"	"RigidModels\\BattleFieldProps\\Textures"	"battle_misc"
"Wall_EU_West_End_piece01_destruct01"	"RigidModels\\BattleFieldProps\\Textures"	"battle_misc"
"west_euro_church_piece01_destruct01"	"RigidModels\\Buildings\\AAA_TEXTURES"	"battle_building"
"west_euro_church_piece01_destruct02"	"RigidModels\\Buildings\\AAA_TEXTURES"	"battle_building"
"west_euro_farmhouse_piece01_destruct01"	"RigidModels\\Buildings\\AAA_TEXTURES"	"battle_building"
"west_euro_farmhouse_piece01_destruct02"	"RigidModels\\Buildings\\AAA_TEXTURES"	"battle_building"
"west_euro_farmhouse_piece01_destruct03"	"RigidModels\\Buildings\\AAA_TEXTURES"	"battle_building"
"west_euro_farmhouse02_piece01_destruct01"	"RigidModels\\Buildings\\AAA_TEXTURES"	"battle_building"
"west_euro_farmhouse02_piece01_destruct02"	"RigidModels\\Buildings\\AAA_TEXTURES"	"battle_building"
"west_euro_farmhouse02_piece01_destruct03"	"RigidModels\\Buildings\\AAA_TEXTURES"	"battle_building"
"west_euro_farmhouse03_piece01_destruct01"	"RigidModels\\Buildings\\AAA_TEXTURES"	"battle_building"
"west_euro_farmhouse03_piece01_destruct02"	"RigidModels\\Buildings\\AAA_TEXTURES"	"battle_building"
"west_euro_farmhouse03_piece01_destruct03"	"RigidModels\\Buildings\\AAA_TEXTURES"	"battle_building"
"west_euro_house01_piece01_destruct01"	"RigidModels\\Buildings\\AAA_TEXTURES"	"battle_building"
"west_euro_house01_piece01_destruct02"	"RigidModels\\Buildings\\AAA_TEXTURES"	"battle_building"
"west_euro_house01b_piece01_destruct01"	"RigidModels\\Buildings\\AAA_TEXTURES"	"battle_building"
"west_euro_house01b_piece01_destruct02"	"RigidModels\\Buildings\\AAA_TEXTURES"	"battle_building"
"west_euro_house02_piece01_destruct01"	"RigidModels\\Buildings\\AAA_TEXTURES"	"battle_building"
"west_euro_house02_piece01_destruct02"	"RigidModels\\Buildings\\AAA_TEXTURES"	"battle_building"
"west_euro_house02b_piece01_destruct01"	"RigidModels\\Buildings\\AAA_TEXTURES"	"battle_building"
"west_euro_house02b_piece01_destruct02"	"RigidModels\\Buildings\\AAA_TEXTURES"	"battle_building"
"west_euro_house03_piece01_destruct01"	"RigidModels\\Buildings\\AAA_TEXTURES"	"battle_building"
"west_euro_house03_piece01_destruct02"	"RigidModels\\Buildings\\AAA_TEXTURES"	"battle_building"
"west_euro_house03b_piece01_destruct01"	"RigidModels\\Buildings\\AAA_TEXTURES"	"battle_building"
"west_euro_house03b_piece01_destruct02"	"RigidModels\\Buildings\\AAA_TEXTURES"	"battle_building"
"west_euro_house04_piece01_destruct01"	"RigidModels\\Buildings\\AAA_TEXTURES"	"battle_building"
"west_euro_house04_piece01_destruct02"	"RigidModels\\Buildings\\AAA_TEXTURES"	"battle_building"
"west_euro_house04b_piece01_destruct01"	"RigidModels\\Buildings\\AAA_TEXTURES"	"battle_building"
"west_euro_house04b_piece01_destruct02"	"RigidModels\\Buildings\\AAA_TEXTURES"	"battle_building"
"west_euro_house05_piece01_destruct01"	"RigidModels\\Buildings\\AAA_TEXTURES"	"battle_building"
"west_euro_house05_piece01_destruct02"	"RigidModels\\Buildings\\AAA_TEXTURES"	"battle_building"
"west_euro_house05b_piece01_destruct01"	"RigidModels\\Buildings\\AAA_TEXTURES"	"battle_building"
"west_euro_house05b_piece01_destruct02"	"RigidModels\\Buildings\\AAA_TEXTURES"	"battle_building"
"west_euro_house06_piece01_destruct01"	"RigidModels\\Buildings\\AAA_TEXTURES"	"battle_building"
"west_euro_house06_piece01_destruct02"	"RigidModels\\Buildings\\AAA_TEXTURES"	"battle_building"
"west_euro_house06b_piece01_destruct01"	"RigidModels\\Buildings\\AAA_TEXTURES"	"battle_building"
"west_euro_house06b_piece01_destruct02"	"RigidModels\\Buildings\\AAA_TEXTURES"	"battle_building"
"west_euro_house07_piece01_destruct01"	"RigidModels\\Buildings\\AAA_TEXTURES"	"battle_building"
"west_euro_house07_piece01_destruct02"	"RigidModels\\Buildings\\AAA_TEXTURES"	"battle_building"
"west_euro_house07a_piece01_destruct01"	"RigidModels\\Buildings\\AAA_TEXTURES"	"battle_building"
"west_euro_house07a_piece01_destruct02"	"RigidModels\\Buildings\\AAA_TEXTURES"	"battle_building"
"west_euro_house07b_piece01_destruct01"	"RigidModels\\Buildings\\AAA_TEXTURES"	"battle_building"
"west_euro_house07b_piece01_destruct02"	"RigidModels\\Buildings\\AAA_TEXTURES"	"battle_building"
"west_euro_house07c_piece01_destruct01"	"RigidModels\\Buildings\\AAA_TEXTURES"	"battle_building"
"west_euro_house07c_piece01_destruct02"	"RigidModels\\Buildings\\AAA_TEXTURES"	"battle_building"
"west_euro_house08_piece01_destruct01"	"RigidModels\\Buildings\\AAA_TEXTURES"	"battle_building"
"west_euro_house08_piece01_destruct02"	"RigidModels\\Buildings\\AAA_TEXTURES"	"battle_building"
"west_euro_house08a_piece01_destruct01"	"RigidModels\\Buildings\\AAA_TEXTURES"	"battle_building"
"west_euro_house08a_piece01_destruct02"	"RigidModels\\Buildings\\AAA_TEXTURES"	"battle_building"
"west_euro_house08b_piece01_destruct01"	"RigidModels\\Buildings\\AAA_TEXTURES"	"battle_building"
"west_euro_house08b_piece01_destruct02"	"RigidModels\\Buildings\\AAA_TEXTURES"	"battle_building"
"west_euro_hut01_piece01_destruct01"	"RigidModels\\Buildings\\AAA_TEXTURES"	"battle_building"
"west_euro_hut01_piece01_destruct02"	"RigidModels\\Buildings\\AAA_TEXTURES"	"battle_building"
"west_euro_hut02_piece01_destruct01"	"RigidModels\\Buildings\\AAA_TEXTURES"	"battle_building"
"west_euro_hut02_piece01_destruct02"	"RigidModels\\Buildings\\AAA_TEXTURES"	"battle_building"
"west_euro_hut03_piece01_destruct01"	"RigidModels\\Buildings\\AAA_TEXTURES"	"battle_building"
"west_euro_hut03_piece01_destruct02"	"RigidModels\\Buildings\\AAA_TEXTURES"	"battle_building"
"west_euro_hut04_piece01_destruct01"	"RigidModels\\Buildings\\AAA_TEXTURES"	"battle_building"
"west_euro_hut04_piece01_destruct02"	"RigidModels\\Buildings\\AAA_TEXTURES"	"battle_building"
"west_euro_hut05_piece01_destruct01"	"RigidModels\\Buildings\\AAA_TEXTURES"	"battle_building"
"west_euro_hut05_piece01_destruct02"	"RigidModels\\Buildings\\AAA_TEXTURES"	"battle_building"
"west_euro_ruins_piece01_destruct01"	"RigidModels\\Buildings\\AAA_TEXTURES"	"battle_building"
"west_euro_rural01_piece01_destruct01"	"RigidModels\\Buildings\\AAA_TEXTURES"	"battle_building"
"west_euro_rural01_piece01_destruct02"	"RigidModels\\Buildings\\AAA_TEXTURES"	"battle_building"
"west_euro_rural02_piece01_destruct01"	"RigidModels\\Buildings\\AAA_TEXTURES"	"battle_building"
"west_euro_rural02_piece01_destruct02"	"RigidModels\\Buildings\\AAA_TEXTURES"	"battle_building"
"west_euro_rural03_piece01_destruct01"	"RigidModels\\Buildings\\AAA_TEXTURES"	"battle_building"
"west_euro_rural03_piece01_destruct02"	"RigidModels\\Buildings\\AAA_TEXTURES"	"battle_building"
"west_euro_stone_bridge_piece01_destruct01"	"RigidModels\\Buildings\\AAA_TEXTURES"	"battle_building"
"west_euro_stone_bridge_piece02_destruct01"	"RigidModels\\Buildings\\AAA_TEXTURES"	"battle_building"
"west_euro_stone_bridge_piece02_destruct02"	"RigidModels\\Buildings\\AAA_TEXTURES"	"battle_building"
"west_euro_townhall_piece01_destruct01"	"RigidModels\\Buildings\\AAA_TEXTURES"	"battle_building"
"west_euro_townhall_piece01_destruct02"	"RigidModels\\Buildings\\AAA_TEXTURES"	"battle_building"
"west_euro_townhall_piece01_destruct03"	"RigidModels\\Buildings\\AAA_TEXTURES"	"battle_building"
"west_euro_townhall_piece02_destruct01"	"RigidModels\\Buildings\\AAA_TEXTURES"	"battle_building"
"west_euro_townhall_piece02_destruct02"	"RigidModels\\Buildings\\AAA_TEXTURES"	"battle_building"
"west_euro_townhall_piece02_destruct03"	"RigidModels\\Buildings\\AAA_TEXTURES"	"battle_building"
"west_euro_townhall_piece03_destruct01"	"RigidModels\\Buildings\\AAA_TEXTURES"	"battle_building"
"west_euro_townhall_piece03_destruct02"	"RigidModels\\Buildings\\AAA_TEXTURES"	"battle_building"
"west_euro_townhall_piece03_destruct03"	"RigidModels\\Buildings\\AAA_TEXTURES"	"battle_building"
"western_fort_armoury_piece01_destruct01"	"RigidModels\\Buildings\\AAA_TEXTURES"	"battle_building"
"western_fort_armoury_piece01_destruct02"	"RigidModels\\Buildings\\AAA_TEXTURES"	"battle_building"
"western_fort_barracks_piece01_destruct01"	"RigidModels\\Buildings\\AAA_TEXTURES"	"battle_building"
"western_fort_barracks_piece01_destruct02"	"RigidModels\\Buildings\\AAA_TEXTURES"	"battle_building"
"western_fort_command_hq_piece01_destruct01"	"RigidModels\\Buildings\\AAA_TEXTURES"	"battle_building"
"western_fort_command_hq_piece01_destruct02"	"RigidModels\\Buildings\\AAA_TEXTURES"	"battle_building"
"woodenfence_1_piece01_destruct01"	"RigidModels\\BattleFieldProps\\Textures"	"battle_misc"
"woodenfence_2_piece01_destruct01"	"RigidModels\\BattleFieldProps\\Textures"	"battle_misc"
"woodenfence_4_piece01_destruct01"	"RigidModels\\BattleFieldProps\\Textures"	"battle_misc"
"woodenfence_8_piece01_destruct01"	"RigidModels\\BattleFieldProps\\Textures"	"battle_misc"
"woodenfence_piece01_destruct01"	"RigidModels\\BattleFieldProps\\Textures"	"battle_misc"
"woodenfenceend_piece01_destruct01"	"RigidModels\\BattleFieldProps\\Textures"	"battle_misc"
"woodengate_piece01_destruct01"	"RigidModels\\BattleFieldProps\\Textures"	"battle_misc"
"woodenstile_piece01_destruct01"	"RigidModels\\BattleFieldProps\\Textures"	"battle_misc"
"EU_City_3_slot"	"RigidModels/CampaignBuildings/Textures"	"campaign_template_extra"
"EU_City_3_slot_fortifications_lvl0"	"RigidModels/CampaignBuildings/Textures"	"campaign_template_extra"
"EU_City_3_slot_fortifications_lvl1"	"RigidModels/CampaignBuildings/Textures"	"campaign_template_extra"
"EU_City_3_slot_fortifications_lvl2"	"RigidModels/CampaignBuildings/Textures"	"campaign_template_extra"
"EU_City_3_slot_fortified"	"RigidModels/CampaignBuildings/Textures"	"campaign_template_extra"
"EU_City_3_slot_fortified_minibuildings_wealth1"	"RigidModels/CampaignBuildings/Textures"	"campaign_template_extra"
"EU_City_3_slot_fortified_minibuildings_wealth2"	"RigidModels/CampaignBuildings/Textures"	"campaign_template_extra"
"EU_City_3_slot_fortified_minibuildings_wealth3"	"RigidModels/CampaignBuildings/Textures"	"campaign_template_extra"
"EU_City_3_slot_fortified_minibuildings_wealth4"	"RigidModels/CampaignBuildings/Textures"	"campaign_template_extra"
"EU_City_3_slot_fortified_minibuildings_wealth5"	"RigidModels/CampaignBuildings/Textures"	"campaign_template_extra"
"EU_City_3_slot_minibuildings_wealth1"	"RigidModels/CampaignBuildings/Textures"	"campaign_template_extra"
"EU_City_3_slot_minibuildings_wealth2"	"RigidModels/CampaignBuildings/Textures"	"campaign_template_extra"
"EU_City_3_slot_minibuildings_wealth3"	"RigidModels/CampaignBuildings/Textures"	"campaign_template_extra"
"EU_City_3_slot_minibuildings_wealth4"	"RigidModels/CampaignBuildings/Textures"	"campaign_template_extra"
"EU_City_3_slot_minibuildings_wealth5"	"RigidModels/CampaignBuildings/Textures"	"campaign_template_extra"
"NA_city_05_gunsmith"	"RigidModels/CampaignBuildings/Textures"	"campaign_building"
"NA_City_3_slot"	"RigidModels/CampaignBuildings/Textures"	"campaign_template"
"NA_City_3_slot_minibuildings_wealth1"	"RigidModels/CampaignBuildings/Textures"	"campaign_template_extra"
"NA_City_3_slot_minibuildings_wealth2"	"RigidModels/CampaignBuildings/Textures"	"campaign_template_extra"
"NA_City_3_slot_minibuildings_wealth3"	"RigidModels/CampaignBuildings/Textures"	"campaign_template_extra"
"NA_City_3_slot_minibuildings_wealth4"	"RigidModels/CampaignBuildings/Textures"	"campaign_template_extra"
"NA_City_3_slot_minibuildings_wealth5"	"RigidModels/CampaignBuildings/Textures"	"campaign_template_extra"
"NA_city_pitmine_lvl1_gems_blend"	"RigidModels/CampaignBuildings/Textures"	"campaign_building"
"NA_city_pitmine_lvl1_gold_blend"	"RigidModels/CampaignBuildings/Textures"	"campaign_building"
"NA_city_pitmine_lvl1_iron_blend"	"RigidModels/CampaignBuildings/Textures"	"campaign_building"
"NA_city_pitmine_lvl1_silver_blend"	"RigidModels/CampaignBuildings/Textures"	"campaign_building"
"NA_pioneer_lvl1"	"RigidModels/CampaignBuildings/Textures"	"campaign_building"
"NA_pioneer_lvl2"	"RigidModels/CampaignBuildings/Textures"	"campaign_building"
"NA_pioneer_lvl3"	"RigidModels/CampaignBuildings/Textures"	"campaign_building"
"NA_town_craft_lvl01smithy"	"RigidModels/CampaignBuildings/Textures"	"campaign_building"
"NA_town_craft_lvl01weave"	"RigidModels/CampaignBuildings/Textures"	"campaign_building"
"NAN_city_05_gunsmith"	"RigidModels/CampaignBuildings/Textures"	"campaign_building"
"NAN_city_chief_lvl01"	"RigidModels/CampaignBuildings/Textures"	"campaign_building"
"NAN_city_chief_lvl02"	"RigidModels/CampaignBuildings/Textures"	"campaign_building"
"NAN_city_chief_lvl03"	"RigidModels/CampaignBuildings/Textures"	"campaign_building"
"NAN_city_chief_lvl04"	"RigidModels/CampaignBuildings/Textures"	"campaign_building"
"NAN_city_market_lvl2"	"RigidModels/CampaignBuildings/Textures"	"campaign_building"
"NAN_city_pitmine_lvl1_gems"	"RigidModels/CampaignBuildings/Textures"	"campaign_building"
"NAN_city_pitmine_lvl1_gems_blend"	"RigidModels/CampaignBuildings/Textures"	"campaign_building"
"NAN_city_pitmine_lvl1_gold"	"RigidModels/CampaignBuildings/Textures"	"campaign_building"
"NAN_city_pitmine_lvl1_gold_blend"	"RigidModels/CampaignBuildings/Textures"	"campaign_building"
"NAN_city_pitmine_lvl1_iron"	"RigidModels/CampaignBuildings/Textures"	"campaign_building"
"NAN_city_pitmine_lvl1_iron_blend"	"RigidModels/CampaignBuildings/Textures"	"campaign_building"
"NAN_city_pitmine_lvl1_silver"	"RigidModels/CampaignBuildings/Textures"	"campaign_building"
"NAN_city_pitmine_lvl1_silver_blend"	"RigidModels/CampaignBuildings/Textures"	"campaign_building"
"NAN_city_religious_lvl1"	"RigidModels/CampaignBuildings/Textures"	"campaign_building"
"NAN_city_religious_lvl2"	"RigidModels/CampaignBuildings/Textures"	"campaign_building"
"NAN_city_religious_lvl3"	"RigidModels/CampaignBuildings/Textures"	"campaign_building"
"NAN_miningcamp_lvl1"	"RigidModels/CampaignBuildings/Textures"	"campaign_building"
"NAN_miningcamp_lvl1_gold"	"RigidModels/CampaignBuildings/Textures"	"campaign_building"
"NAN_miningcamp_lvl1_iron"	"RigidModels/CampaignBuildings/Textures"	"campaign_building"
"NAN_miningcamp_lvl1_silver"	"RigidModels/CampaignBuildings/Textures"	"campaign_building"
"NAN_pioneer_lvl1"	"RigidModels/CampaignBuildings/Textures"	"campaign_building"
"NAN_pioneer_lvl2"	"RigidModels/CampaignBuildings/Textures"	"campaign_building"
"NAN_pioneer_lvl3"	"RigidModels/CampaignBuildings/Textures"	"campaign_building"
"NAN_resource_fishery_lvl01"	"RigidModels/CampaignBuildings/Textures"	"campaign_building"
"NAN_resource_fishery_lvl02"	"RigidModels/CampaignBuildings/Textures"	"campaign_building"
"NAN_resource_tpost_lvl01_blend"	"RigidModels/CampaignBuildings/Textures"	"campaign_building"
"NAN_resource_tpost_lvl02_blend"	"RigidModels/CampaignBuildings/Textures"	"campaign_building"
"NAN_town_craft_lvl01"	"RigidModels/CampaignBuildings/Textures"	"campaign_building"
"NAN_town_craft_lvl01pots"	"RigidModels/CampaignBuildings/Textures"	"campaign_building"
"NAN_town_craft_lvl01smithy"	"RigidModels/CampaignBuildings/Textures"	"campaign_building"
"NAN_town_craft_lvl01weave"	"RigidModels/CampaignBuildings/Textures"	"campaign_building"
"NAN_town_craft_lvl02pots"	"RigidModels/CampaignBuildings/Textures"	"campaign_building"
"NAN_town_craft_lvl02smithy"	"RigidModels/CampaignBuildings/Textures"	"campaign_building"
"NAN_town_craft_lvl02weave"	"RigidModels/CampaignBuildings/Textures"	"campaign_building"
"NAN_town_happy_lvl01"	"RigidModels/CampaignBuildings/Textures"	"campaign_building"
"NAN_town_happy_lvl02"	"RigidModels/CampaignBuildings/Textures"	"campaign_building"
"NAN_town_horse_lvl01"	"RigidModels/CampaignBuildings/Textures"	"campaign_building"
"NAN_town_horse_lvl02"	"RigidModels/CampaignBuildings/Textures"	"campaign_building"
"NAN_town_spiritual_lvl01"	"RigidModels/CampaignBuildings/Textures"	"campaign_building"
"NAN_town_spiritual_lvl02"	"RigidModels/CampaignBuildings/Textures"	"campaign_building"
"NAN_town_warrior_lvl01"	"RigidModels/CampaignBuildings/Textures"	"campaign_building"
"NAN_town_warrior_lvl02"	"RigidModels/CampaignBuildings/Textures"	"campaign_building"
"NAN_town_warrior_lvl03"	"RigidModels/CampaignBuildings/Textures"	"campaign_building"
"NA_miningcamp_lvl1_gems"	"RigidModels/CampaignBuildings/Textures"	"campaign_building"
"NA_miningcamp_lvl1_gold"	"RigidModels/CampaignBuildings/Textures"	"campaign_building"
"NA_miningcamp_lvl1_iron"	"RigidModels/CampaignBuildings/Textures"	"campaign_building"
"NA_miningcamp_lvl1_silver"	"RigidModels/CampaignBuildings/Textures"	"campaign_building"
"NAN_miningcamp_lvl1_gems"	"RigidModels/CampaignBuildings/Textures"	"campaign_building"
